geneID,Gene_name,Chr,Start,End,Gene_length
FBgn0031081,Nep3,X,19961297,19969323,8026
FBgn0031085,CG9570,X,20051294,20052519,1225
FBgn0062565,Or19b,X,20094398,20095767,1369
FBgn0031088,CG15322,X,20133579,20138878,5299
FBgn0041626,Or19a,X,20141819,20143188,1369
FBgn0031080,CG12655,X,19958393,19959403,1010
FBgn0053217,CG33217,3L,23126025,23132209,6184
FBgn0052350,Vps11,3L,23147656,23150499,2843
FBgn0024733,RpL10,3L,23093190,23095471,2281
FBgn0040372,G9a,X,245978,254650,8672
FBgn0000316,cin,X,255674,258469,2795
FBgn0024989,CG3777,X,279703,350504,70801
FBgn0040371,CG12470,X,307684,308935,1251
FBgn0029521,Or1a,X,315123,316566,1443
FBgn0004034,y,X,356509,361245,4736
FBgn0029522,CG13373,X,476984,478191,1207
FBgn0052817,CG32817,X,479066,480166,1100
FBgn0029524,CG3176,X,481862,482768,906
FBgn0023536,CG3156,X,487878,490725,2847
FBgn0023534,CG17778,X,494614,496369,1755
FBgn0023535,arg,X,509435,528028,18593
FBgn0023537,CG17896,X,490787,493495,2708
FBgn0029525,CG18273,X,482777,487581,4804
FBgn0029523,CR18275,X,476857,479309,2452
FBgn0010019,Cyp4g1,X,467057,469335,2278
FBgn0052816,CG32816,X,316576,470726,154150
FBgn0040370,CG13375,X,283186,294962,11776
FBgn0040373,CG3038,X,243954,245856,1902
FBgn0000108,Appl,X,530501,579044,48543
FBgn0025640,CG13369,X,623468,624765,1297
FBgn0025635,Hinfp,X,625542,628016,2474
FBgn0001341,Mybbp1A,X,629773,633633,3860
FBgn0003575,su(sable),X,635890,643760,7870
FBgn0025634,CG13367,X,644761,646386,1625
FBgn0025638,Roc1a,X,647304,648597,1293
FBgn0040383,CG5254,X,750347,758719,8372
FBgn0040382,CG5273,X,759594,761939,2345
FBgn0027343,fz3,X,769945,784222,14277
FBgn0025621,CG16989,X,793147,797061,3914
FBgn0026874,CG13358,X,803424,804921,1497
FBgn0015799,Rbf,X,797090,801479,4389
FBgn0025620,CG13360,X,787855,790089,2234
FBgn0015288,RpL22,X,762560,765130,2570
FBgn0029531,CG13362,X,749241,751301,2060
FBgn0025639,Hmt4-20,X,648483,656033,7550
FBgn0002579,RpL36,X,628338,629483,1145
FBgn0026879,CG13364,X,624757,625203,446
FBgn0029529,CG13365,X,620717,621215,498
FBgn0025633,spdi,X,585081,620195,35114
FBgn0040339,MED22,X,928139,928860,721
FBgn0052815,CG32815,X,932466,939424,6958
FBgn0040340,TRAM,X,935232,937822,2590
FBgn0040347,mus81,X,941075,943229,2154
FBgn0040337,CG3021,X,1026791,1028290,1499
FBgn0040398,CG14629,X,1051525,1052631,1106
FBgn0040397,CG3655,X,1073041,1134896,61855
FBgn0026143,Cdc45,X,1028291,1030556,2265
FBgn0040351,CG11638,X,1013984,1026703,12719
FBgn0040349,CG3699,X,946662,947500,838
FBgn0040348,CG3703,X,942474,945773,3299
FBgn0040346,CG3704,X,939170,940805,1635
FBgn0040342,CG3706,X,930931,932475,1544
FBgn0040343,CG3713,X,846171,847157,986
FBgn0052814,CG32814,X,1019795,1026700,6905
FBgn0040364,CG11378,X,1170828,1173797,2969
FBgn0040361,CG14627,X,1181620,1183502,1882
FBgn0040360,CG14626,X,1184778,1188585,3807
FBgn0040359,CG11380,X,1191308,1196660,5352
FBgn0040358,CG14625,X,1199546,1203157,3611
FBgn0040367,CG11382,X,1209970,1211853,1883
FBgn0025642,CG32812,X,1287290,1288945,1655
FBgn0004650,fs(1)N,X,1322513,1329438,6925
FBgn0024362,Naa30A,X,1342106,1344770,2664
FBgn0024361,Tsp2A,X,1346553,1348143,1590
FBgn0024364,CG11417,X,1354014,1356473,2459
FBgn0029573,CG14770,X,1369249,1370176,927
FBgn0024987,ssx,X,1370580,1375257,4677
FBgn0023169,AMPKalpha,X,1375536,1378896,3360
FBgn0052813,CG32813,X,1380914,1392843,11929
FBgn0024985,Rilpl,X,1393054,1397337,4283
FBgn0027794,Lrpprc2,X,1457175,1460617,3442
FBgn0027795,CG14785,X,1455215,1457054,1839
FBgn0024986,CG3719,X,1378885,1380480,1595
FBgn0000826,png,X,1356488,1357601,1113
FBgn0024365,CG12773,X,1349623,1353981,4358
FBgn0024360,MTPAP,X,1344872,1349357,4485
FBgn0024366,CG11409,X,1329518,1341587,12069
FBgn0025641,DAAM,X,1289713,1322362,32649
FBgn0028550,Atf3,X,1242740,1275284,32544
FBgn0026876,CG11403,X,1236873,1239884,3011
FBgn0040366,CG11398,X,1211989,1215156,3167
FBgn0040368,eIF4E7,X,1158599,1162389,3790
FBgn0026872,CG14777,X,1466134,1468692,2558
FBgn0029580,CG14778,X,1467493,1470614,3121
FBgn0025383,CG14780,X,1472522,1473727,1205
FBgn0025381,rush,X,1478552,1481420,2868
FBgn0025394,inc,X,1483479,1517615,34136
FBgn0000482,dor,X,1665052,1668451,3399
FBgn0001189,hfw,X,1669570,1673608,4038
FBgn0029587,CG14797,X,1681566,1684891,3325
FBgn0024897,b6,X,1686624,1690187,3563
FBgn0025391,Scgdelta,X,1735945,1754065,18120
FBgn0023130,a6,X,1693615,1695889,2274
FBgn0023530,CG3740,X,1668406,1669297,891
FBgn0025390,Mur2B,X,1523554,1668788,145234
FBgn0025393,CG14795,X,1512227,1512803,576
FBgn0003517,sta,X,1481797,1483413,1616
FBgn0044508,snoRNA:M,X,1482492,1482590,98
FBgn0025382,Rab27,X,1473884,1476974,3090
FBgn0052808,CG32808,X,1468693,1469817,1124
FBgn0027791,O-fut2,X,1464363,1465996,1633
FBgn0027793,CG14787,X,1460807,1461676,869
FBgn0026873,MED18,X,1865909,1866887,978
FBgn0023513,CG14803,X,1868870,1872408,3538
FBgn0014411,Vps26,X,1873853,1876474,2621
FBgn0023514,CG14805,X,1877317,1879077,1760
FBgn0029594,Coa8,X,1880282,1881432,1150
FBgn0023519,mRpL16,X,1890256,1891482,1226
FBgn0023509,mip130,X,1908239,1920318,12079
FBgn0023510,Rbcn-3B,X,1908920,1916825,7905
FBgn0023508,Ocrl,X,1922981,1927524,4543
FBgn0023522,CG11596,X,1927683,1930517,2834
FBgn0023521,CG3587,X,1940307,1941536,1229
FBgn0025627,CG4194,X,2068592,2069688,1096
FBgn0025630,Rtca,X,2072413,2074890,2477
FBgn0025629,CG4045,X,2074795,2075900,1105
FBgn0029596,CG14054,X,2065273,2066359,1086
FBgn0025626,CG4281,X,2062313,2065142,2829
FBgn0025625,Sik2,X,2055310,2061915,6605
FBgn0025631,moody,X,2044292,2050120,5828
FBgn0026878,CG4325,X,2042730,2043818,1088
FBgn0000667,Actn,X,2023822,2042311,18489
FBgn0003964,usp,X,2038798,2042311,3513
FBgn0023545,PIG-K,X,2007911,2009364,1453
FBgn0023520,CG3857,X,1937700,1940040,2340
FBgn0023512,eIF2Bepsilon,X,1920166,1922874,2708
FBgn0023511,Edem1,X,1903704,1908827,5123
FBgn0052801,CG32801,X,1902082,1903177,1095
FBgn0023518,trr,X,1881313,1889950,8637
FBgn0026088,CG14818,X,1879019,1879774,755
FBgn0026089,CG14817,X,1876294,1877270,976
FBgn0023517,Pgam5,X,1872400,1873565,1165
FBgn0023516,Pex5,X,1866832,1869061,2229
FBgn0023515,Gcna,X,1862009,1865835,3826
FBgn0028969,deltaCOP,X,1859141,1861790,2649
FBgn0026090,Lamtor5,X,1857889,1858971,1082
FBgn0029590,CG14811,X,1821469,1822381,912
FBgn0025624,CG4025,X,2076966,2078455,1489
FBgn0040395,Unc-76,X,2080610,2093948,13338
FBgn0000382,csw,X,2094234,2115701,21467
FBgn0023507,D2hgdh,X,2141489,2144937,3448
FBgn0004654,Pgd,X,2145136,2148566,3430
FBgn0023540,CG3630,X,2162196,2172281,10085
FBgn0025839,ND-B14.5A,X,2172526,2173432,906
FBgn0011576,Cyp4d2,X,2176006,2178728,2722
FBgn0015036,Cyp4ae1,X,2179007,2180998,1991
FBgn0003116,pn,X,2181211,2182916,1705
FBgn0040899,CG17776,X,2184725,2185258,533
FBgn0040900,CG17777,X,2186855,2187741,886
FBgn0023549,Mct1,X,2189188,2205373,16185
FBgn0029606,CG14052,X,2223754,2224969,1215
FBgn0003048,pcx,X,2225296,2238045,12749
FBgn0000810,fs(1)K10,X,2242138,2246041,3903
FBgn0023523,Or2a,X,2246231,2247567,1336
FBgn0023527,CG3071,X,2262837,2264825,1988
FBgn0040391,CG2854,X,2327128,2328941,1813
FBgn0053218,lncRNA:CR33218,X,2330159,2330826,667
FBgn0003079,Raf,X,2295466,2343870,48404
FBgn0003159,CG2841,X,2344949,2366356,21407
FBgn0040389,mRpL14,X,2343997,2344649,652
FBgn0044047,Ilp6,X,2331493,2334658,3165
FBgn0040392,CG14050,X,2324748,2326217,1469
FBgn0023526,CG2865,X,2278031,2293411,15380
FBgn0023529,Grp170,X,2271008,2275068,4060
FBgn0023528,CG2924,X,2264657,2270761,6104
FBgn0027296,temp,X,2260207,2262515,2308
FBgn0023524,CG3078,X,2254403,2259863,5460
FBgn0023525,CG3191,X,2250145,2251993,1848
FBgn0000377,crn,X,2247594,2249983,2389
FBgn0001330,kz,X,2237858,2242035,4177
FBgn0004397,Vinc,X,2214347,2222567,8220
FBgn0023550,FarO,X,2201820,2203866,2046
FBgn0029603,CG14053,X,2191639,2193909,2270
FBgn0023542,Nmd3,X,2182818,2184668,1850
FBgn0023541,Cyp4d14,X,2173415,2175315,1900
FBgn0005670,Cyp4d1,X,2159145,2162180,3035
FBgn0004655,wapl,X,2149936,2158983,9047
FBgn0013432,bcn92,X,2148463,2149647,1184
FBgn0004861,ph-p,X,2126210,2138371,12161
FBgn0004860,ph-d,X,2115727,2123286,7559
FBgn0040394,CG16903,X,2078343,2080405,2062
FBgn0040376,AANATL7,X,2580958,2583823,2865
FBgn0040066,wds,X,2585980,2588217,2237
FBgn0001404,egh,X,2588503,2599111,10608
FBgn0040336,Seipin,X,2619799,2622140,2341
FBgn0040333,brv3,X,2622069,2624575,2506
FBgn0040334,Tsp3A,X,2617758,2619738,1980
FBgn0029629,eIF3g1,X,2609247,2610336,1089
FBgn0011566,Smyd3,X,2606680,2608876,2196
FBgn0011606,Klp3A,X,2599158,2604052,4894
FBgn0040375,CG13760,X,2583745,2585699,1954
FBgn0040377,Vha36-3,X,2579091,2580560,1469
FBgn0040388,boi,X,2444167,2470043,25876
FBgn0003714,tko,X,2442313,2443976,1663
FBgn0001150,gt,X,2427113,2428967,1854
FBgn0003371,sgg,X,2633952,2679553,45601
FBgn0003068,per,X,2685580,2692780,7200
FBgn0024993,Lint-O,X,2698701,2701033,2332
FBgn0024996,eIF2Bbeta,X,2704571,2706217,1646
FBgn0024997,CG2681,X,2708684,2711668,2984
FBgn0024991,CG2694,X,2714079,2717654,3575
FBgn0000928,fs(1)Yb,X,2720468,2724158,3690
FBgn0000927,fs(1)Ya,X,2724286,2726577,2291
FBgn0000520,dwg,X,2727698,2730042,2344
FBgn0024975,CG2712,X,2732469,2734402,1933
FBgn0003996,w,X,2790599,2796466,5867
FBgn0040384,CG32795,X,2782906,2790567,7661
FBgn0024980,Syx4,X,2739089,2744076,4987
FBgn0000376,crm,X,2734248,2738773,4525
FBgn0024973,CG2701,X,2717638,2720327,2689
FBgn0024998,CG2685,X,2711756,2713960,2204
FBgn0024995,CG2680,X,2706151,2707427,1276
FBgn0024994,Ugalt,X,2701124,2703852,2728
FBgn0024992,Spg7,X,2694392,2698211,3819
FBgn0000092,dyw,X,2692732,2693886,1154
FBgn0025838,CG2652,X,2681987,2682932,945
FBgn0011276,HLH3B,X,2680199,2681723,1524
FBgn0004647,N,X,3134870,3172221,37351
FBgn0040396,CG3939,X,3175018,3176223,1205
FBgn0000479,dnc,X,3176440,3343767,167327
FBgn0029660,CG10801,X,3460592,3462500,1908
FBgn0029662,CG12206,X,3465737,3474524,8787
FBgn0029659,CG16782,X,3459016,3460240,1224
FBgn0029657,CG12535,X,3387944,3448943,60999
FBgn0000644,Fcp3C,X,3173376,3174474,1098
FBgn0028746,CG18508,X,3172268,3173140,872
FBgn0052793,CG32793,X,2929796,2932626,2830
FBgn0029643,CG14420,X,2938856,2940527,1671
FBgn0029644,CG14421,X,2941408,2942329,921
FBgn0029646,CG14423,X,2945403,2946589,1186
FBgn0029648,CG3603,X,2948034,2949120,1086
FBgn0028369,kirre,X,2740384,3134532,394148
FBgn0003285,rst,X,2950399,2973834,23435
FBgn0025644,CG14424,X,2925884,2927258,1374
FBgn0029639,CG14419,X,2885186,2885914,728
FBgn0040353,CG14417,X,2875428,2876533,1105
FBgn0040352,CG14416,X,2871884,2872853,969
FBgn0029664,CG10802,X,3482965,3484555,1590
FBgn0029666,CG10803,X,3485650,3490915,5265
FBgn0029669,CG13021,X,3514316,3515757,1441
FBgn0052792,ppk8,X,3557812,3572000,14188
FBgn0044046,Ilp7,X,3667621,3668845,1224
FBgn0023215,Mnt,X,3671801,3701672,29871
FBgn0015286,Rala,X,3704610,3719635,15025
FBgn0023216,Parg,X,3668837,3671502,2665
FBgn0029672,CG2875,X,3571456,3573622,2166
FBgn0052791,DIP-alpha,X,3507245,3571649,64404
FBgn0029667,Gas8,X,3491011,3504851,13840
FBgn0029665,CG14270,X,3484605,3485378,773
FBgn0029663,CG10804,X,3476463,3482322,5859
FBgn0028491,CG2930,X,3868973,3880379,11406
FBgn0029681,CG15239,X,3884168,3890486,6318
FBgn0029686,Glos,X,3936517,3940582,4065
FBgn0052786,Gem4b,X,3940847,3944265,3418
FBgn0052783,Gem4c,X,3945043,3948460,3417
FBgn0029687,Vap33,X,3948975,3955442,6467
FBgn0029690,CG6414,X,3968788,3971350,2562
FBgn0029689,CG6428,X,3965435,3968655,3220
FBgn0029688,lva,X,3955543,3965327,9784
FBgn0029685,CG2938,X,3932000,3936469,4469
FBgn0019661,lncRNA:roX1,X,3857230,3862697,5467
FBgn0029694,CG15375,X,4101318,4102995,1677
FBgn0000221,brn,X,4104342,4105791,1449
FBgn0026084,cib,X,4106113,4110981,4868
FBgn0026085,dgt4,X,4113701,4114929,1228
FBgn0026083,tyf,X,4117020,4130016,12996
FBgn0066114,GlcAT-I,X,4131211,4132833,1622
FBgn0029697,CG15570,X,4218170,4223331,5161
FBgn0029706,CG3626,X,4366417,4371136,4719
FBgn0029705,CG12693,X,4327080,4329457,2377
FBgn0040907,mRpL33,X,4321764,4322231,467
FBgn0002707,mei-9,X,4314230,4318801,4571
FBgn0040906,CG15579,X,4311279,4311799,520
FBgn0029703,CG12692,X,4300117,4302346,2229
FBgn0000635,Fas2,X,4132887,4206093,73206
FBgn0026080,Tip60,X,4114800,4117487,2687
FBgn0026079,Nsun2,X,4111156,4113734,2578
FBgn0004832,Xpac,X,4102955,4104197,1242
FBgn0029693,Cmtr1,X,4097592,4101031,3439
FBgn0000179,bi,X,4412856,4485647,72791
FBgn0029708,CG3556,X,4530231,4535464,5233
FBgn0029709,CHOp24,X,4540908,4542506,1598
FBgn0029710,CG3568,X,4542630,4544497,1867
FBgn0029712,CG15912,X,4549070,4549957,887
FBgn0029714,CG3527,X,4551973,4553006,1033
FBgn0022768,Pp2C1,X,4679988,4686903,6915
FBgn0029715,CG11444,X,4553117,4554398,1281
FBgn0029713,CG11436,X,4549883,4551878,1995
FBgn0029711,Usf,X,4544617,4548794,4177
FBgn0003210,rb,X,4535635,4540626,4991
FBgn0052773,lncRNA:CR32773,X,4387676,4611385,223709
FBgn0011760,ctp,X,4687800,4702034,14234
FBgn0028325,Pdha,X,4702284,4705265,2981
FBgn0029722,CG7024,X,4705309,4707504,2195
FBgn0029727,CG6978,X,4784075,4786059,1984
FBgn0029730,boil,X,4875670,4877263,1593
FBgn0029733,CG6927,X,4906900,4908821,1921
FBgn0052772,CG32772,X,4909102,4915161,6059
FBgn0029737,Hgsnat,X,4918730,4921648,2918
FBgn0004368,Ptp4E,X,4939128,4955916,16788
FBgn0029728,CG2861,X,4797231,4804862,7631
FBgn0029745,Rpn13R,X,5131898,5132985,1087
FBgn0029746,CG15465,X,5085759,5254864,169105
FBgn0003449,snf,X,5309242,5310501,1259
FBgn0011761,dhd,X,5312171,5313125,954
FBgn0029753,CG4198,X,5313258,5315190,1932
FBgn0029755,Sas10,X,5317409,5319071,1662
FBgn0014024,Rnp4F,X,5318928,5322696,3768
FBgn0029754,CG15930,X,5315130,5317295,2165
FBgn0029752,TrxT,X,5310581,5311888,1307
FBgn0029751,CG17764,X,5306261,5307417,1156
FBgn0029750,CG3323,X,5302988,5305691,2703
FBgn0052767,CG32767,X,5071027,5084768,13741
FBgn0026751,XRCC1,X,5329876,5332435,2559
FBgn0010014,CanB,X,5332499,5334449,1950
FBgn0029761,SK,X,5340236,5405138,64902
FBgn0029763,Usp16-45,X,5421533,5427219,5686
FBgn0029765,CG16756,X,5427517,5428217,700
FBgn0029766,CG15784,X,5429571,5432526,2955
FBgn0029768,SPR,X,5446656,5494012,47356
FBgn0029771,CG12730,X,5516608,5518771,2163
FBgn0026702,Pop1,X,5622648,5625493,2845
FBgn0004687,Mlc-c,X,5619136,5622539,3403
FBgn0029778,RhoGAP5A,X,5616572,5618806,2234
FBgn0029769,frma,X,5493014,5496052,3038
FBgn0029762,NAAT1,X,5405238,5410849,5611
FBgn0029756,CG3309,X,5326675,5329347,2672
FBgn0028474,CG4119,X,5666052,5670652,4600
FBgn0029785,RpL35,X,5672401,5673547,1146
FBgn0003747,Gr5a,X,5680617,5682488,1871
FBgn0000394,cv,X,5690002,5693084,3082
FBgn0029791,AdamTS-B,X,5698557,5708633,10076
FBgn0029795,CG15773,X,5732740,5734614,1874
FBgn0029798,Rtel1,X,5747747,5752077,4330
FBgn0029799,CG15772,X,5752249,5754041,1792
FBgn0029801,CG15771,X,5755574,5759751,4177
FBgn0029809,CG15767,X,5789487,5790919,1432
FBgn0029810,CG12239,X,5792140,5794543,2403
FBgn0029814,CG15765,X,5818559,5840823,22264
FBgn0029820,CG16721,X,5879869,5883391,3522
FBgn0029821,CG4020,X,5905746,5908001,2255
FBgn0029822,CG12236,X,5908135,5913079,4944
FBgn0029823,Shmt,X,5913067,5916797,3730
FBgn0029819,Usp30,X,5877000,5879787,2787
FBgn0014340,mof,X,5873840,5876853,3013
FBgn0029818,GAA1,X,5870841,5873357,2516
FBgn0029813,AgmNAT,X,5814864,5815820,956
FBgn0029804,CG3097,X,5765855,5770780,4925
FBgn0013987,MAPk-Ak2,X,5759908,5764203,4295
FBgn0029800,lin-52,X,5753390,5754958,1568
FBgn0261383,IntS6,X,5738663,5747254,8591
FBgn0052758,Snx27,X,5719374,5738031,18657
FBgn0053080,CG33080,X,5708559,5717778,9219
FBgn0027564,CG3149,X,5692945,5695205,2260
FBgn0029789,PGAP1,X,5685253,5689473,4220
FBgn0046687,Tre1,X,5673830,5679977,6147
FBgn0015794,Rab18,X,5670827,5671812,985
FBgn0029783,Sirt4,X,5664628,5665940,1312
FBgn0029824,CG3726,X,5917097,5941852,24755
FBgn0029825,CG12728,X,5942606,5945250,2644
FBgn0052756,CG32756,X,5945682,5948353,2671
FBgn0029826,CG6041,X,5948160,5950208,2048
FBgn0052755,CG32755,X,5950251,5951711,1460
FBgn0029828,CG6067,X,5955629,5958283,2654
FBgn0029830,Grip,X,5966279,5986699,20420
FBgn0029831,CG5966,X,5988791,5992640,3849
FBgn0029833,MCTS1,X,6037892,6039576,1684
FBgn0029834,CG5937,X,6040005,6050381,10376
FBgn0029835,CG5921,X,6050828,6065646,14818
FBgn0029843,Nep1,X,6091205,6103971,12766
FBgn0029849,Efr,X,6219957,6222719,2762
FBgn0003514,sqh,X,6223061,6225140,2079
FBgn0029848,Btnd,X,6217268,6219327,2059
FBgn0052750,CG32750,X,6194737,6196439,1702
FBgn0026060,Mipp2,X,6082709,6091471,8762
FBgn0029840,raptor,X,6082634,6090201,7567
FBgn0029839,CG4660,X,6078708,6081372,2664
FBgn0029838,CG4666,X,6076072,6077786,1714
FBgn0029837,Tsp5D,X,6069131,6074857,5726
FBgn0003302,rux,X,6035753,6037800,2047
FBgn0029003,mab-21,X,6008183,6013181,4998
FBgn0027546,CG4766,X,5997508,6000797,3289
FBgn0005390,fs(1)M3,X,5958207,5964247,6040
FBgn0029851,CG14445,X,6237315,6240558,3243
FBgn0015818,Spx,X,6255822,6257596,1774
FBgn0029853,Josd,X,6261169,6262119,950
FBgn0028982,Spt6,X,6267797,6274984,7187
FBgn0029857,wuho,X,6288100,6289562,1462
FBgn0029858,mldr,X,6291303,6294177,2874
FBgn0029861,CG3815,X,6295389,6298970,3581
FBgn0029863,CG3823,X,6303975,6306745,2770
FBgn0029864,CG15894,X,6309212,6329828,20616
FBgn0029866,CG3842,X,6337762,6343731,5969
FBgn0029867,CG3847,X,6347103,6349236,2133
FBgn0029873,CG3918,X,6524464,6526342,1878
FBgn0014031,Agxt,X,6528948,6530726,1778
FBgn0000524,dx,X,6533999,6538575,4576
FBgn0014026,RpL7A,X,6530897,6533348,2451
FBgn0029874,CG3342,X,6526106,6527888,1782
FBgn0003139,PpV,X,6371065,6372915,1850
FBgn0003655,swa,X,6363418,6365708,2290
FBgn0016974,swaPsi,X,6361496,6363310,1814
FBgn0029868,ND-B16.6,X,6349016,6350401,1385
FBgn0043796,CG12219,X,6299054,6301285,2231
FBgn0028685,Rpt4,X,6289470,6291245,1775
FBgn0026015,Top3beta,X,6284138,6287990,3852
FBgn0029856,CG11700,X,6282037,6283575,1538
FBgn0052745,CR32745,X,6280233,6280752,519
FBgn0040918,schlank,X,6257668,6267228,9560
FBgn0004611,Plc21C,2L,305935,355566,49631
FBgn0053127,CG33127,2L,322101,323091,990
FBgn0000061,al,2L,378112,387439,9327
FBgn0003278,Polr1B,2L,404285,407969,3684
FBgn0002593,RpLP1,2L,419952,420864,912
FBgn0031254,CG13692,2L,421771,422489,718
FBgn0031255,BBS8,2L,422873,425321,2448
FBgn0004583,ex,2L,431227,448701,17474
FBgn0031256,shv,2L,453108,454654,1546
FBgn0031257,CG4133,2L,455531,458745,3214
FBgn0027592,MED15,2L,473013,476170,3157
FBgn0003963,ush,2L,476220,540560,64340
FBgn0031263,Tspo,2L,559612,560523,911
FBgn0031265,CG2794,2L,564163,566472,2309
FBgn0031266,Sf3b1,2L,568340,572907,4567
FBgn0031268,cold,2L,574291,575734,1443
FBgn0023489,Pph13,2L,577486,579549,2063
FBgn0010323,Gsc,2L,583540,594685,11145
FBgn0013323,Ptth,2L,575711,576896,1185
FBgn0031267,Ipk2,2L,573033,574264,1231
FBgn0021874,Nle,2L,566366,568121,1755
FBgn0031264,uncNacbeta,2L,560568,563819,3251
FBgn0005660,Ets21C,2L,544925,552923,7998
FBgn0031260,Spp,2L,542786,544653,1867
FBgn0010602,lwr,2L,540599,542580,1981
FBgn0043364,cbt,2L,476446,479688,3242
FBgn0031258,CG4297,2L,458876,472200,13324
FBgn0015924,crq,2L,448254,453024,4770
FBgn0031253,CG11885,2L,420895,421450,555
FBgn0031252,CG13690,2L,418434,419652,1218
FBgn0031251,CG4213,2L,396595,402198,5603
FBgn0031250,Ent1,2L,355565,357874,2309
FBgn0051921,CG31921,2L,329910,332335,2425
FBgn0031249,CG11911,2L,320279,321248,969
FBgn0067779,dbr,2L,66482,71390,4908
FBgn0031213,galectin,2L,71757,76211,4454
FBgn0031214,CG11374,2L,76348,77783,1435
FBgn0031216,Zir,2L,94739,102086,7347
FBgn0031217,Creld,2L,102380,104142,1762
FBgn0001142,Gs1,2L,132077,134472,2395
FBgn0031224,CG11454,2L,143323,144227,904
FBgn0031228,ND-15,2L,114726,156030,41304
FBgn0031229,CG3436,2L,156029,157666,1637
FBgn0031231,mRpL10,2L,203779,204782,1003
FBgn0031233,Tbc1d15-17,2L,207179,210725,3546
FBgn0031235,CG13693,2L,232487,234208,1721
FBgn0031240,CG3345,2L,269088,271626,2538
FBgn0003444,smo,2L,277582,282167,4585
FBgn0031247,CG11562,2L,292419,293222,803
FBgn0024352,Stip1,2L,295122,297449,2327
FBgn0020622,Pi3K21B,2L,297880,305233,7353
FBgn0017457,U2af38,2L,292959,294681,1722
FBgn0025686,Amnionless,2L,287252,289144,1892
FBgn0031245,CG3625,2L,283385,291795,8410
FBgn0031244,CG11601,2L,281670,283269,1599
FBgn0031238,Dus1,2L,252589,271744,19155
FBgn0031239,CG17075,2L,259949,267505,7556
FBgn0031232,CG11617,2L,204743,207297,2554
FBgn0031227,Pus10,2L,153539,155305,1766
FBgn0051974,CG31974,2L,141077,143091,2014
FBgn0051975,CG31975,2L,138384,140992,2608
FBgn0051976,ovm,2L,138384,140992,2608
FBgn0031219,CG13694,2L,115365,116488,1123
FBgn0026787,Nhe1,2L,103962,106732,2770
FBgn0002931,net,2L,82421,87387,4966
FBgn0051973,Cda5,2L,25402,65404,40002
FBgn0031209,Ir21a,2L,21823,25155,3332
FBgn0002121,l(2)gl,2L,9839,21376,11537
FBgn0036970,Spn77Bc,3L,20342634,20344319,1685
FBgn0036974,eRF1,3L,20348355,20353873,5518
FBgn0036975,CG5618,3L,20353449,20356632,3183
FBgn0024887,kin17,3L,20356807,20358331,1524
FBgn0001259,in,3L,20367198,20370259,3061
FBgn0036979,CG13247,3L,20370313,20371746,1433
FBgn0036980,RhoBTB,3L,20376242,20382398,6156
FBgn0036985,zye,3L,20413604,20424309,10705
FBgn0036991,CtIP,3L,20436250,20438370,2120
FBgn0036993,CG5910,3L,20442419,20450580,8161
FBgn0036996,mag,3L,20460683,20462274,1591
FBgn0036997,Tdh,3L,20466944,20469592,2648
FBgn0036998,CG5969,3L,20473783,20474791,1008
FBgn0036999,isoQC,3L,20474466,20477003,2537
FBgn0037001,ND-39,3L,20492082,20497084,5002
FBgn0052425,CG32425,3L,20497323,20514107,16784
FBgn0037003,CG18281,3L,20499836,20501500,1664
FBgn0037004,CG17637,3L,20504186,20505700,1514
FBgn0037005,CG5078,3L,20506032,20507375,1343
FBgn0037009,CG5104,3L,20521009,20522434,1425
FBgn0037011,Nubp2,3L,20526576,20527910,1334
FBgn0001323,knrl,3L,20597141,20620659,23518
FBgn0037012,Rcd2,3L,20527972,20540417,12445
FBgn0037008,mTerf3,3L,20519590,20520772,1182
FBgn0037007,BNIP3,3L,20514598,20519393,4795
FBgn0037000,ZnT77C,3L,20484293,20494921,10628
FBgn0052428,CG32428,3L,20469674,20473723,4049
FBgn0036995,atk,3L,20454690,20464862,10172
FBgn0036994,CG5199,3L,20450532,20452864,2332
FBgn0036992,Hpd,3L,20438166,20439872,1706
FBgn0036990,mRpL15,3L,20435110,20436209,1099
FBgn0029158,Las,3L,20430605,20432361,1756
FBgn0036988,CG5262,3L,20427962,20430475,2513
FBgn0036987,CG5274,3L,20426199,20427666,1467
FBgn0036986,CG5282,3L,20424424,20426071,1647
FBgn0036984,CG13248,3L,20407103,20410566,3463
FBgn0028978,trbl,3L,20396288,20401609,5321
FBgn0027565,CG5498,3L,20382405,20384109,1704
FBgn0001247,Ide,3L,20371672,20375896,4224
FBgn0036973,Rbbp5,3L,20345736,20347942,2206
FBgn0037014,CG13251,3L,20637199,20640910,3711
FBgn0037016,CG13252,3L,20730591,20744508,13917
FBgn0040634,CG4186,3L,20769586,20770138,552
FBgn0016696,Pitslre,3L,20771528,20776931,5403
FBgn0037020,Pex14,3L,20778799,20780378,1579
FBgn0037024,tzn,3L,20798645,20800081,1436
FBgn0037025,Spc105R,3L,20800410,20806853,6443
FBgn0037027,HIPP1,3L,20809669,20813332,3663
FBgn0037030,CG3288,3L,20836182,20837153,971
FBgn0040636,CG13255,3L,20837488,20838839,1351
FBgn0037031,CG11456,3L,20841987,20844340,2353
FBgn0040637,CG11458,3L,20905795,20906331,536
FBgn0037035,CG10589,3L,20927826,20929190,1364
FBgn0011591,fng,3L,20925891,20949512,23621
FBgn0052432,CG32432,3L,20844332,20885188,40856
FBgn0027055,CSN3,3L,20839096,20841576,2480
FBgn0037026,CG3634,3L,20806868,20809272,2404
FBgn0027364,Six4,3L,20788886,20792777,3891
FBgn0037022,CG11396,3L,20786340,20788137,1797
FBgn0037021,Pcif1,3L,20780350,20786197,5847
FBgn0037019,Pex16,3L,20776766,20778264,1498
FBgn0037018,CG4042,3L,20770143,20771507,1364
FBgn0037017,CG4074,3L,20768207,20769500,1293
FBgn0045474,Gr77a,3L,20737569,20739430,1861
FBgn0037015,cmpy,3L,20712838,20719200,6362
FBgn0001320,kni,3L,20692330,20695378,3048
FBgn0037044,Pdss2,3L,21027915,21030141,2226
FBgn0028402,Polr3E,3L,21031825,21033561,1736
FBgn0026179,siz,3L,21034535,21075444,40909
FBgn0053284,CG33284,3L,21123753,21124884,1131
FBgn0037050,ICA69,3L,21131446,21133310,1864
FBgn0037057,CG10512,3L,21202920,21208092,5172
FBgn0037060,CG10508,3L,21210215,21216051,5836
FBgn0028427,Ilk,3L,21216901,21219240,2339
FBgn0004865,Eip78C,3L,21226609,21266503,39894
FBgn0037061,Trmt112,3L,21215995,21216839,844
FBgn0037059,CG10510,3L,21208148,21210084,1936
FBgn0053056,Targ2,3L,21198261,21203232,4971
FBgn0053054,Targ1,3L,21197411,21202882,5471
FBgn0041100,park,3L,21194754,21196853,2099
FBgn0024150,Ac78C,3L,21136447,21171930,35483
FBgn0037051,CG10565,3L,21133250,21136353,3103
FBgn0020294,ko,3L,21075581,21131159,55578
FBgn0053285,CG33285,3L,21088223,21088989,766
FBgn0037045,CG10584,3L,21030280,21031360,1080
FBgn0003415,skd,3L,20992814,21027434,34620
FBgn0053286,CG33286,3L,20970812,20974700,3888
FBgn0053287,CG33287,3L,20966766,20970663,3897
FBgn0037040,CG12983,3L,20962655,20966762,4107
FBgn0037071,CG7632,3L,21304697,21306197,1500
FBgn0037073,Tsr1,3L,21335215,21338232,3017
FBgn0052436,CG32436,3L,21344033,21355049,11016
FBgn0053288,CG33288,3L,21427790,21433066,5276
FBgn0005694,Aef1,3L,21433422,21438639,5217
FBgn0037087,CG7519,3L,21493083,21493907,824
FBgn0037090,Est-Q,3L,21501421,21503959,2538
FBgn0037092,M6,3L,21507852,21512749,4897
FBgn0037093,Cdk12,3L,21516306,21522684,6378
FBgn0037094,CG7611,3L,21523186,21528163,4977
FBgn0015283,Rpn10,3L,21537000,21538582,1582
FBgn0028663,VhaM9.7-b,3L,21539862,21541215,1353
FBgn0037101,CG7634,3L,21565426,21567785,2359
FBgn0052438,SMC5,3L,21569176,21573523,4347
FBgn0052441,EMC10,3L,21574131,21575874,1743
FBgn0037102,CRIF,3L,21568059,21568898,839
FBgn0037099,CG7173,3L,21555373,21558226,2853
FBgn0037098,Wnk,3L,21543850,21554928,11078
FBgn0029152,Mkrn1,3L,21529959,21533713,3754
FBgn0026371,SAK,3L,21512141,21515887,3746
FBgn0015239,Hr78,3L,21494019,21497494,3475
FBgn0037086,CG7202,3L,21491399,21492773,1374
FBgn0037085,Neu2,3L,21484891,21490586,5695
FBgn0014143,croc,3L,21474133,21476479,2346
FBgn0037082,CG5664,3L,21438628,21441363,2735
FBgn0037081,barc,3L,21420388,21433134,12746
FBgn0037078,CG12971,3L,21355100,21356495,1395
FBgn0037076,ebd2,3L,21344768,21349288,4520
FBgn0037074,Tbc1d8-9,3L,21337681,21343716,6035
FBgn0003042,Pc,3L,21306138,21318020,11882
FBgn0037070,CG11309,3L,21301785,21304658,2873
FBgn0037067,Cpr78Ca,3L,21291860,21292800,940
FBgn0037065,CG12974,3L,21281752,21285962,4210
FBgn0027945,ppl,3L,21280491,21281506,1015
FBgn0037064,CG9389,3L,21268392,21270580,2188
FBgn0037063,CG9391,3L,21266680,21268335,1655
FBgn0037106,CG11307,3L,21617623,21619873,2250
FBgn0037108,Alg11,3L,21625806,21628571,2765
FBgn0037110,ORMDL,3L,21635305,21636251,946
FBgn0043783,CG32444,3L,21636947,21639060,2113
FBgn0052445,CG32445,3L,21639359,21640710,1351
FBgn0052446,Atox1,3L,21640995,21642599,1604
FBgn0037115,CG11249,3L,21672139,21674518,2379
FBgn0037117,CG11248,3L,21680050,21683231,3181
FBgn0037121,Polr2H,3L,21728932,21729694,762
FBgn0037128,CG14572,3L,21741534,21742441,907
FBgn0037133,CG7370,3L,21769815,21771321,1506
FBgn0000560,eg,3L,21808703,21817600,8897
FBgn0022936,CycH,3L,21821997,21823309,1312
FBgn0037134,CG7407,3L,21823461,21824571,1110
FBgn0037135,eIF2A,3L,21824740,21827856,3116
FBgn0037138,P5CDh1,3L,21836665,21841356,4691
FBgn0046301,CG7148,3L,21830544,21832253,1709
FBgn0052448,CG32448,3L,21827774,21828480,706
FBgn0037130,Syn1,3L,21745359,21770534,25175
FBgn0037129,CG14565,3L,21743248,21744269,1021
FBgn0037127,CG14566,3L,21739479,21740309,830
FBgn0037126,CG14567,3L,21737706,21738430,724
FBgn0037120,CG11247,3L,21724326,21728806,4480
FBgn0052447,CG32447,3L,21690612,21706365,15753
FBgn0037116,Als2,3L,21674394,21679755,5361
FBgn0037109,MED1,3L,21628325,21634446,6121
FBgn0037107,CG7166,3L,21620000,21625647,5647
FBgn0037105,S1P,3L,21613797,21617376,3579
FBgn0037140,SLC22A,3L,21934704,21938636,3932
FBgn0037142,CG14562,3L,21942221,21949866,7645
FBgn0037143,CR7448,3L,21949825,21951550,1725
FBgn0037144,CG7458,3L,21955110,21958041,2931
FBgn0029091,Chs2,3L,21962401,21969964,7563
FBgn0037146,P5CS,3L,21972002,21984606,12604
FBgn0000045,Act79B,3L,21985210,21987190,1980
FBgn0004514,Oct-TyrR,3L,22035003,22065279,30276
FBgn0037149,CG14561,3L,22065907,22067216,1309
FBgn0000100,RpLP0,3L,22075867,22077487,1620
FBgn0037151,CG7130,3L,22075056,22075756,700
FBgn0037150,CG7133,3L,22073068,22074523,1455
FBgn0027532,CG7139,3L,22067270,22071848,4578
FBgn0037147,CG7140,3L,22026230,22028325,2095
FBgn0037141,PolH,3L,21938634,21941812,3178
FBgn0015075,Ddx1,3L,22263369,22266017,2648
FBgn0004179,Csp,3L,22267382,22273745,6363
FBgn0025702,Srpk79D,3L,22273985,22284335,10350
FBgn0027086,IleRS,3L,22288665,22292810,4145
FBgn0037164,CG11438,3L,22465619,22468076,2457
FBgn0037165,CG11437,3L,22468862,22469853,991
FBgn0037166,CG11426,3L,22470556,22473509,2953
FBgn0037167,CG11425,3L,22474795,22475792,997
FBgn0037163,laza,3L,22458816,22461131,2315
FBgn0004449,Ten-m,3L,22293044,22407863,114819
FBgn0011771,Hem,3L,22284354,22288195,3841
FBgn0037156,CG11523,3L,22265806,22266679,873
FBgn0028500,Rich,3L,22257749,22262921,5172
FBgn0037174,Jhbp6,3L,22669956,22680034,10078
FBgn0037176,CG14456,3L,22687222,22688288,1066
FBgn0037181,CG11370,3L,22712155,22713660,1505
FBgn0052452,CG32452,3L,22717728,22719943,2215
FBgn0037185,CG11367,3L,22728111,22733446,5335
FBgn0260481,CG32454,3L,22729766,22731600,1834
FBgn0037188,CG7369,3L,22741793,22748614,6821
FBgn0052451,SPoCk,3L,22749444,22787631,38187
FBgn0037191,CG14448,3L,22788439,22789247,808
FBgn0010830,l(3)04053,3L,22738602,22741388,2786
FBgn0037186,CG11241,3L,22732013,22738420,6407
FBgn0037184,CG14450,3L,22726234,22727789,1555
FBgn0037183,CG14451,3L,22721230,22722091,861
FBgn0037182,ArfGAP3,3L,22714313,22717577,3264
FBgn0037171,CG14459,3L,22573114,22637916,64802
FBgn0037195,CG11226,3L,22837068,22838170,1102
FBgn0053169,CG33169,3L,22863864,22864496,632
FBgn0037200,Nsun6,3L,22872200,22873702,1502
FBgn0037202,Ssl1,3L,22879089,22880963,1874
FBgn0037203,slif,3L,22881045,22893821,12776
FBgn0037205,BoYb,3L,22901912,22905470,3558
FBgn0037206,CG12768,3L,22910491,22923532,13041
FBgn0037207,Mes2,3L,22945657,22952248,6591
FBgn0044324,Chro,3L,22873702,22878984,5282
FBgn0010348,Arf1,3L,22868380,22872231,3851
FBgn0020518,snoRNA:Me28S-G764,3L,22869545,22869622,77
FBgn0037199,EMC4,3L,22867175,22868243,1068
FBgn0052459,CG32459,3L,22854583,22856059,1476
FBgn0052462,CG32462,3L,22852270,22853512,1242
FBgn0046878,Obp83cd,3R,6108134,6109733,1599
FBgn0037402,Vha14-2,3R,6122592,6124405,1813
FBgn0037405,CG1077,3R,6167483,6170309,2826
FBgn0037408,NPFR,3R,6187315,6195403,8088
FBgn0037409,Osi24,3R,6198811,6207678,8867
FBgn0037410,Osi2,3R,6209373,6213493,4120
FBgn0037411,Osi3,3R,6215832,6218199,2367
FBgn0027527,Osi6,3R,6234708,6237181,2473
FBgn0037414,Osi7,3R,6248994,6251683,2689
FBgn0037415,Osi8,3R,6255175,6256602,1427
FBgn0037416,Osi9,3R,6260211,6262105,1894
FBgn0037419,Osi12,3R,6278531,6282495,3964
FBgn0037421,CG15594,3R,6287733,6289824,2091
FBgn0037427,Osi17,3R,6311772,6327308,15536
FBgn0037412,Osi4,3R,6218318,6221781,3463
FBgn0046875,Obp83g,3R,6111671,6112302,631
FBgn0046876,Obp83ef,3R,6109642,6111034,1392
FBgn0026077,Gasp,3R,6088799,6100887,12088
FBgn0037398,CG15580,3R,6054712,6057536,2824
FBgn0037396,CtsL3,3R,6025826,6027238,1412
FBgn0037374,jagn,3R,5779315,5781308,1993
FBgn0037375,kat-60L1,3R,5781762,5787465,5703
FBgn0028690,Rpn5,3R,5789493,5791569,2076
FBgn0037377,Hpf1,3R,5791879,5793383,1504
FBgn0037379,CG10979,3R,5794705,5799994,5289
FBgn0037384,dgrn,3R,5824615,5826576,1961
FBgn0037386,CG1208,3R,5831639,5838782,7143
FBgn0037387,CG1213,3R,5841170,5846568,5398
FBgn0037388,CG14676,3R,5847220,5848177,957
FBgn0028436,ECSIT,3R,5856585,5857914,1329
FBgn0003261,Rm62,3R,6000426,6008579,8153
FBgn0010403,Obp83b,3R,5976177,5976817,640
FBgn0011281,Obp83a,3R,5972155,5975245,3090
FBgn0037391,CG2017,3R,5858083,5862405,4322
FBgn0029088,disp,3R,5849697,5856311,6614
FBgn0037383,Sec20,3R,5822026,5824532,2506
FBgn0037382,Hpr1,3R,5818794,5821440,2646
FBgn0037378,PSMG1,3R,5793308,5794317,1009
FBgn0037376,Hat1,3R,5787337,5789384,2047
FBgn0037372,Dcps,3R,5753318,5754774,1456
FBgn0037329,POLDIP2,3R,5467778,5469566,1788
FBgn0011715,Snr1,3R,5470926,5472754,1828
FBgn0037332,Hcs,3R,5474899,5485393,10494
FBgn0051550,CG31550,3R,5485543,5489489,3946
FBgn0010051,Itpr,3R,5517117,5539411,22294
FBgn0037338,Snm1,3R,5555084,5557786,2702
FBgn0037341,CG12746,3R,5564865,5567435,2570
FBgn0041191,Rheb,3R,5568921,5570491,1570
FBgn0037345,PolZ2,3R,5588873,5589703,830
FBgn0037347,SecS,3R,5601433,5603185,1752
FBgn0019637,Atu,3R,5613358,5615939,2581
FBgn0037351,RpL13A,3R,5624474,5625947,1473
FBgn0051549,CG31549,3R,5632192,5633321,1129
FBgn0037354,CG12171,3R,5633627,5634640,1013
FBgn0037356,CG12170,3R,5637234,5638657,1423
FBgn0037359,MED27,3R,5655139,5656336,1197
FBgn0046222,Wdr33,3R,5660635,5665169,4534
FBgn0037363,Atg17,3R,5669713,5679930,10217
FBgn0037368,CG1239,3R,5733513,5734702,1189
FBgn0037370,CG1236,3R,5736748,5738013,1265
FBgn0027497,Madm,3R,5742510,5747138,4628
FBgn0037371,Sym,3R,5738178,5742476,4298
FBgn0037369,CG2100,3R,5734698,5736355,1657
FBgn0037365,CG2104,3R,5690891,5693286,2395
FBgn0037364,Rab23,3R,5680054,5685434,5380
FBgn0010772,Xe7,3R,5665139,5669334,4195
FBgn0037360,CG2182,3R,5656236,5659912,3676
FBgn0037358,elm,3R,5652640,5654861,2221
FBgn0027951,MTA1-like,3R,5638655,5648738,10083
FBgn0051548,CG31548,3R,5635901,5636852,951
FBgn0051546,CG31546,3R,5634626,5635624,998
FBgn0044823,Spec2,3R,5616644,5624125,7481
FBgn0037350,Dph4,3R,5622119,5624125,2006
FBgn0017550,Rga,3R,5607275,5613112,5837
FBgn0014366,noi,3R,5589601,5591459,1858
FBgn0037344,CG2926,3R,5579301,5588380,9079
FBgn0037342,CG2931,3R,5567502,5568615,1113
FBgn0037340,CG14671,3R,5563977,5564815,838
FBgn0037339,Pi4KIIalpha,3R,5557663,5563652,5989
FBgn0037336,CG2519,3R,5539510,5547775,8265
FBgn0010399,Nmdar1,3R,5508842,5523328,14486
FBgn0051547,NKCC,3R,5489505,5502702,13197
FBgn0015402,ksr,3R,5478390,5483906,5516
FBgn0025825,HDAC3,3R,5472810,5474600,1790
FBgn0037330,mRpL44,3R,5469463,5470636,1173
FBgn0037328,RpL35A,3R,5465630,5467101,1471
FBgn0037327,PEK,3R,5458563,5464753,6190
FBgn0037295,dpr16,3R,5150908,5170121,19213
FBgn0037294,CG12590,3R,5159612,5160901,1289
FBgn0037297,CG1116,3R,5219657,5221548,1891
FBgn0037299,Vps37B,3R,5226158,5227526,1368
FBgn0037301,Mms19,3R,5232543,5236288,3745
FBgn0037304,CG1113,3R,5253153,5255403,2250
FBgn0037310,Tim17b1,3R,5300145,5301186,1041
FBgn0051542,CG31542,3R,5369540,5371744,2204
FBgn0003275,Polr2F,3R,5371795,5372397,602
FBgn0037324,Orco,3R,5407183,5412406,5223
FBgn0037323,CG2663,3R,5400594,5404135,3541
FBgn0037322,Or83a,3R,5397643,5399196,1553
FBgn0001311,kkv,3R,5378093,5392866,14773
FBgn0037315,Cerk,3R,5358873,5368306,9433
FBgn0037312,CG11999,3R,5353717,5354747,1030
FBgn0051538,CG31538,3R,5275678,5277835,2157
FBgn0037307,Tim17a2,3R,5258336,5262692,4356
FBgn0037305,Enoph,3R,5255444,5256681,1237
FBgn0260462,CtsF,3R,5237651,5251745,14094
FBgn0053293,CG33293,3R,5240014,5240735,721
FBgn0040208,Kat60,3R,5227289,5232209,4920
FBgn0037298,CG2604,3R,5221632,5223365,1733
FBgn0037296,Prosbeta2R2,3R,5217751,5219528,1777
FBgn0004913,Gnf1,3R,4906622,4910081,3459
FBgn0037290,Jhbp1,3R,4965445,4968485,3040
FBgn0037293,RabGGTa,3R,5128087,5129939,1852
FBgn0010313,corto,3R,5077779,5087072,9293
FBgn0037292,plh,3R,4986500,5011031,24531
FBgn0037291,CG14662,3R,4981999,4984232,2233
FBgn0037288,Jhbp3,3R,4953506,4955252,1746
FBgn0004436,Ubc6,3R,4948755,4952682,3927
FBgn0037262,MED31,3R,4641963,4643292,1329
FBgn0037263,slx1,3R,4641963,4644636,2673
FBgn0037265,spartin,3R,4654800,4657985,3185
FBgn0010750,atms,3R,4750035,4777490,27455
FBgn0037279,Gmppb,3R,4811444,4816025,4581
FBgn0037280,BBS5,3R,4816318,4817776,1458
FBgn0037282,CG14657,3R,4817980,4821432,3452
FBgn0026417,Hus1-like,3R,4808336,4812096,3760
FBgn0037276,Ccdc39,3R,4781120,4784722,3602
FBgn0037275,CG14655,3R,4777497,4780302,2805
FBgn0027570,Nep2,3R,4719458,4731878,12420
FBgn0037270,eIF3f1,3R,4712882,4714182,1300
FBgn0040466,Dlip2,3R,4644649,4645655,1006
FBgn0037261,CG9775,3R,4638010,4641838,3828
FBgn0027930,MP1,3R,4307908,4309835,1927
FBgn0037232,Suv3,3R,4311555,4315398,3843
FBgn0040687,CG14645,3R,4335098,4335506,408
FBgn0037235,CG1103,3R,4337755,4339914,2159
FBgn0037238,CG1090,3R,4359883,4366855,6972
FBgn0037239,Sfxn1-3,3R,4378600,4381210,2610
FBgn0037240,Cont,3R,4381306,4387018,5712
FBgn0003882,tub,3R,4387742,4389813,2071
FBgn0037241,CG14646,3R,4390366,4392111,1745
FBgn0037244,CG14647,3R,4400510,4402017,1507
FBgn0051528,CG31528,3R,4416438,4417665,1227
FBgn0037250,CG1074,3R,4433965,4436175,2210
FBgn0037252,CG14650,3R,4437387,4441328,3941
FBgn0037254,sac,3R,4480812,4484215,3403
FBgn0037255,Fip1,3R,4485008,4487677,2669
FBgn0051523,CG31523,3R,4465421,4479207,13786
FBgn0051522,CG31522,3R,4441415,4462883,21468
FBgn0037251,Lipt2,3R,4436222,4437329,1107
FBgn0037249,eIF3a,3R,4429798,4433895,4097
FBgn0037248,srl,3R,4422483,4429335,6852
FBgn0052944,CG32944,3R,4407227,4419578,12351
FBgn0037242,March5,3R,4395979,4397875,1896
FBgn0037236,Skp2,3R,4334879,4337674,2795
FBgn0037231,Vps24,3R,4307435,4310947,3512
FBgn0037230,Nepl11,3R,4292274,4294840,2566
FBgn0037213,CG12581,3R,4174632,4186751,12119
FBgn0037215,beta-Man,3R,4197206,4204572,7366
FBgn0037218,aux,3R,4211783,4227518,15735
FBgn0015331,abs,3R,4233047,4235041,1994
FBgn0010225,Gel,3R,4235217,4241057,5840
FBgn0037223,TwdlU,3R,4243606,4245511,1905
FBgn0037227,TwdlV,3R,4254708,4255833,1125
FBgn0037228,CG1092,3R,4266770,4268316,1546
FBgn0037229,flip,3R,4269221,4277928,8707
FBgn0037225,TwdlG,3R,4248723,4251341,2618
FBgn0037220,CG14641,3R,4230779,4232342,1563
FBgn0051516,CG31516,3R,4218463,4220130,1667
FBgn0037217,CG14636,3R,4204493,4215314,10821
FBgn0000500,Dsk,3R,4189692,4190260,568
FBgn0031670,SelT,2L,5010922,5012127,1205
FBgn0000299,Col4a1,2L,5029609,5037279,7670
FBgn0260470,SP555,2L,5037709,5040818,3109
FBgn0031676,senju,2L,5052843,5054575,1732
FBgn0031682,CG5828,2L,5093976,5095910,1934
FBgn0031683,CG4230,2L,5096227,5099294,3067
FBgn0031684,ND-13A,2L,5099177,5100288,1111
FBgn0031681,Pgant5,2L,5072170,5093592,21422
FBgn0028694,Rpn11,2L,5058404,5059790,1386
FBgn0031678,Nepl3,2L,5055982,5058248,2266
FBgn0022023,eIF3h,2L,5051193,5053094,1901
FBgn0031675,CG9121,2L,5047818,5051062,3244
FBgn0031673,CG31650,2L,5040648,5044712,4064
FBgn0016075,vkg,2L,5012144,5028191,16047
FBgn0031668,CG31917,2L,5009931,5010834,903
FBgn0053113,Rtnl1,2L,4992808,5009720,16912
FBgn0046776,CR14033,2L,5242699,5244239,1540
FBgn0031693,Cyp4ac1,2L,5264001,5265899,1898
FBgn0031694,Cyp4ac2,2L,5266392,5268455,2063
FBgn0031695,Cyp4ac3,2L,5268498,5270329,1831
FBgn0031696,Bub1,2L,5278865,5283283,4418
FBgn0016076,vri,2L,5288944,5311223,22279
FBgn0015031,cype,2L,5327227,5327969,742
FBgn0031701,TotM,2L,5329857,5330464,607
FBgn0016920,nompC,2L,5346200,5365760,19560
FBgn0016660,H15,2L,5404280,5416593,12313
FBgn0031703,Acsf2,2L,5339132,5342234,3102
FBgn0031702,fusl,2L,5330470,5338073,7603
FBgn0031700,CG14022,2L,5327975,5328879,904
FBgn0031698,Ncoa6,2L,5315290,5326683,11393
FBgn0031697,CG14024,2L,5311311,5314895,3584
FBgn0000228,Nin,2L,5271728,5278548,6820
FBgn0003716,tkv,2L,5219000,5271384,52384
FBgn0031707,CG14020,2L,5517737,5518949,1212
FBgn0000318,cl,2L,5520135,5521382,1247
FBgn0031711,Elp4,2L,5524139,5525809,1670
FBgn0051989,Cap-D3,2L,5525905,5535958,10053
FBgn0051648,Cox11,2L,5526957,5527854,897
FBgn0051915,CG31915,2L,5528123,5530682,2559
FBgn0002525,Lam,2L,5542480,5546642,4162
FBgn0031717,Oscillin,2L,5547086,5549614,2528
FBgn0031721,CG14017,2L,5553897,5555137,1240
FBgn0004620,GluRIIA,2L,5555072,5558994,3922
FBgn0031724,CG18266,2L,5596833,5598636,1803
FBgn0031728,Hsp60C,2L,5662849,5670838,7989
FBgn0051646,DIP-theta,2L,5626291,5658560,32269
FBgn0031725,DIP-eta,2L,5601723,5617946,16223
FBgn0031723,CG7251,2L,5587115,5588414,1299
FBgn0014189,Hel25E,2L,5539326,5542314,2988
FBgn0031716,CG14015,2L,5536850,5539196,2346
FBgn0031713,Coq6,2L,5530620,5532223,1603
FBgn0031710,Vps52,2L,5521281,5523898,2617
FBgn0031708,CG7382,2L,5518893,5519896,1003
FBgn0031730,CG7236,2L,5706374,5713791,7417
FBgn0024191,sip1,2L,5721051,5723944,2893
FBgn0031736,CG11030,2L,5724656,5762420,37764
FBgn0031735,CG11029,2L,5746157,5747961,1804
FBgn0051912,asRNA:CR31912,2L,5769752,5771537,1785
FBgn0031740,CG7239,2L,5802220,5804030,1810
FBgn0031741,CG11034,2L,5805395,5809063,3668
FBgn0031746,CG9029,2L,5886002,5886609,607
FBgn0043362,bchs,2L,5907169,5922776,15607
FBgn0015381,dsf,2L,5925937,5939261,13324
FBgn0001128,Gpdh1,2L,5943643,5948968,5325
FBgn0031752,CG9044,2L,5949450,5955235,5785
FBgn0031753,CG13999,2L,5955312,5956466,1154
FBgn0031751,CG9016,2L,5922876,5923653,777
FBgn0031745,rau,2L,5859769,5879498,19729
FBgn0051644,COX6CL,2L,5817890,5818443,553
FBgn0031739,CG14005,2L,5800517,5801975,1458
FBgn0031738,CG9171,2L,5767002,5800253,33251
FBgn0031737,obst-E,2L,5762553,5766142,3589
FBgn0031734,CG11147,2L,5733675,5741244,7569
FBgn0031733,CG14006,2L,5726415,5728811,2396
FBgn0031731,CG14007,2L,5715349,5716680,1331
FBgn0001942,eIF4A,2L,5981764,5985909,4145
FBgn0001941,ifc,2L,5986348,5988854,2506
FBgn0031760,Tsp26A,2L,6000228,6003738,3510
FBgn0031763,CG13996,2L,6020835,6021718,883
FBgn0051643,CG31643,2L,6038117,6041283,3166
FBgn0031768,IPIP,2L,6048002,6050474,2472
FBgn0031769,CG9135,2L,6050800,6053877,3077
FBgn0031770,CG13995,2L,6054302,6060169,5867
FBgn0031772,CG13994,2L,6062989,6063671,682
FBgn0031774,CG9147,2L,6065997,6067635,1638
FBgn0031776,Pfdn1,2L,6069079,6069838,759
FBgn0051642,CG31642,2L,6118512,6120522,2010
FBgn0031784,CG9222,2L,6131023,6132484,1461
FBgn0031785,CG13991,2L,6139382,6145010,5628
FBgn0051639,CG31639,2L,6153840,6155141,1301
FBgn0031782,WDR79,2L,6125879,6127775,1896
FBgn0031779,CG9175,2L,6096698,6098966,2268
FBgn0031777,CG9154,2L,6069790,6070686,896
FBgn0031775,CG9150,2L,6067668,6068594,926
FBgn0031773,Fbw5,2L,6063562,6065953,2391
FBgn0031771,ND-51,2L,6060842,6062757,1915
FBgn0029161,slmo,2L,6046516,6048706,2190
FBgn0000052,Pfas,2L,6041181,6046050,4869
FBgn0031766,CG9117,2L,6036997,6037902,905
FBgn0025742,mtm,2L,6034731,6037015,2284
FBgn0031764,CG9107,2L,6022951,6024539,1588
FBgn0001170,H2.0,2L,6013059,6019402,6343
FBgn0001089,Gal,2L,6003574,6006827,3253
FBgn0031759,Kdm5,2L,5989400,5999501,10101
FBgn0000308,chic,2L,5972115,5981018,8903
FBgn0026755,Ugt37B1,2L,6225048,6226842,1794
FBgn0031791,AANATL2,2L,6255859,6256822,963
FBgn0260452,CG13984,2L,6308819,6309475,656
FBgn0015623,Cpr,2L,6338836,6346280,7444
FBgn0031803,ppk14,2L,6354956,6356672,1716
FBgn0031805,Nepl4,2L,6367882,6370190,2308
FBgn0043854,slam,2L,6372388,6377284,4896
FBgn0031808,Nepl5,2L,6381266,6383419,2153
FBgn0031811,CG13982,2L,6412315,6415335,3020
FBgn0031815,frj,2L,6456052,6459008,2956
FBgn0031820,Daxx,2L,6480929,6487576,6647
FBgn0027496,epsilonCOP,2L,6489090,6490194,1104
FBgn0051638,CG31638,2L,6491061,6496988,5927
FBgn0031824,CG9547,2L,6492974,6494532,1558
FBgn0031822,Phf5a,2L,6490155,6490843,688
FBgn0031818,CG9536,2L,6474438,6476975,2537
FBgn0031817,HemK1,2L,6466217,6467698,1481
FBgn0031816,Rchy1,2L,6459015,6465669,6654
FBgn0031814,retm,2L,6448464,6455929,7465
FBgn0011722,Tig,2L,6415179,6423310,8131
FBgn0031801,CG9498,2L,6349393,6351034,1641
FBgn0031800,CG9497,2L,6346430,6348427,1997
FBgn0031799,Pez,2L,6332881,6338671,5790
FBgn0031826,CG9550,2L,6497053,6498466,1413
FBgn0051637,CG31637,2L,6498647,6526996,28349
FBgn0031830,COX5B,2L,6557800,6559308,1508
FBgn0031831,COX5BL,2L,6559431,6560133,702
FBgn0031836,CG11050,2L,6611011,6617117,6106
FBgn0028467,Ube4A,2L,6658517,6662033,3516
FBgn0000392,cup,2L,6663664,6674780,11116
FBgn0031851,Aatf,2L,6717625,6719389,1764
FBgn0046704,Liprin-alpha,2L,6723903,6732766,8863
FBgn0031853,TTLL3B,2L,6732866,6736149,3283
FBgn0031855,meng,2L,6742502,6756133,13631
FBgn0051910,CG31910,2L,6744663,6745622,959
FBgn0031854,TTLL3A,2L,6736364,6740188,3824
FBgn0025777,homer,2L,6719394,6723359,3965
FBgn0025595,AkhR,2L,6711286,6716186,4900
FBgn0031850,Tsp,2L,6686791,6709086,22295
FBgn0031849,CG11327,2L,6684842,6686712,1870
FBgn0028703,Nhe3,2L,6677835,6684364,6529
FBgn0031848,Nse1,2L,6676649,6677625,976
FBgn0000351,cort,2L,6674682,6676635,1953
FBgn0028990,Spn27A,2L,6671065,6673347,2282
FBgn0031844,CG13771,2L,6662061,6663612,1551
FBgn0051636,CG31636,2L,6656459,6658152,1693
FBgn0051633,CG31633,2L,6654760,6656321,1561
FBgn0051635,CG31635,2L,6632798,6649114,16316
FBgn0051634,Oatp26F,2L,6625138,6632407,7269
FBgn0031837,DIP-iota,2L,6617134,6621700,4566
FBgn0031834,CG13766,2L,6564112,6566181,2069
FBgn0031832,Trmt6,2L,6559426,6562289,2863
FBgn0031829,IFT52,2L,6555717,6557502,1785
FBgn0031858,CG17378,2L,6774041,6778444,4403
FBgn0031860,Daao2,2L,6803011,6804372,1361
FBgn0051632,sens-2,2L,6821934,6838995,17061
FBgn0017551,Rca1,2L,6852315,6853866,1551
FBgn0031866,Nlg2,2L,6874900,6906656,31756
FBgn0031868,Rat1,2L,6908083,6911423,3340
FBgn0004838,Hrb27C,2L,6920704,6932057,11353
FBgn0020616,SA1,2L,6950421,6954586,4165
FBgn0031875,CG3430,2L,6957008,6959104,2096
FBgn0031877,Hmgcl,2L,6960377,6961653,1276
FBgn0021944,Coprox,2L,6964421,6965887,1466
FBgn0031879,uif,2L,6972828,7010359,37531
FBgn0016978,snRNP-U1-70K,2L,6968711,6971737,3026
FBgn0031878,sip2,2L,6961516,6964074,2558
FBgn0031876,Atac1,2L,6959099,6960328,1229
FBgn0031874,CG13775,2L,6954357,6956950,2593
FBgn0031873,Gas41,2L,6949310,6950207,897
FBgn0031872,ihog,2L,6945464,6948808,3344
FBgn0031871,Fgop2,2L,6943178,6945289,2111
FBgn0031869,CG18304,2L,6932545,6942814,10269
FBgn0028554,x16,2L,6914301,6920210,5909
FBgn0026196,nop5,2L,6916753,6918743,1990
FBgn0052829,CG32829,2L,6915581,6916445,864
FBgn0011737,Wee1,2L,6911090,6914138,3048
FBgn0042092,Polr1F,2L,6906666,6907844,1178
FBgn0031865,Nha1,2L,6860905,6870389,9484
FBgn0031861,CG17375,2L,6804324,6805792,1468
FBgn0042189,CG17376,2L,6799946,6800894,948
FBgn0015776,nrv1,2L,6778555,6786861,8306
FBgn0031857,LUBEL,2L,6759829,6772755,12926
FBgn0031856,CG11322,2L,6757864,6759628,1764
FBgn0003046,Pcp,2L,7021682,7022470,788
FBgn0031881,MME1,2L,7027526,7028959,1433
FBgn0031885,Mnn1,2L,7056301,7063586,7285
FBgn0031893,MICU1,2L,7182234,7185529,3295
FBgn0051909,CG31909,2L,7257512,7258198,686
FBgn0031897,CG13784,2L,7204538,7220033,15495
FBgn0031896,CG4502,2L,7194908,7204264,9356
FBgn0031895,CG4497,2L,7190431,7194588,4157
FBgn0031894,CG4496,2L,7185461,7190010,4549
FBgn0031888,Pvf2,2L,7069536,7084635,15099
FBgn0031886,Nuf2,2L,7064431,7065837,1406
FBgn0051907,Mst27D,2L,7059214,7060851,1637
FBgn0031882,Rab30,2L,7030493,7032606,2113
FBgn0051908,CG31908,2L,7024829,7027389,2560
FBgn0031902,Wnt6,2L,7333714,7352542,18828
FBgn0031903,Wnt10,2L,7363379,7377528,14149
FBgn0002938,ninaC,2L,7377702,7384344,6642
FBgn0031905,gudu,2L,7388508,7390902,2394
FBgn0031907,CG5171,2L,7401335,7404727,3392
FBgn0031908,CG5177,2L,7405227,7408600,3373
FBgn0031910,CG15818,2L,7410909,7412229,1320
FBgn0028387,chm,2L,7412417,7422736,10319
FBgn0031914,CG5973,2L,7437492,7445882,8390
FBgn0031918,CG6055,2L,7466543,7472493,5950
FBgn0031920,CG6441,2L,7474704,7476952,2248
FBgn0011283,Obp28a,2L,7496791,7497365,574
FBgn0045495,Gr28b,2L,7454826,7462247,7421
FBgn0025697,santa-maria,2L,7445355,7451244,5889
FBgn0031913,CG5958,2L,7430530,7433516,2986
FBgn0031909,CG5181,2L,7408533,7409809,1276
FBgn0031906,CG5160,2L,7390984,7398750,7766
FBgn0031904,CG5149,2L,7384486,7388253,3767
FBgn0031925,Cyp4d21,2L,7605600,7607701,2101
FBgn0031926,CG6739,2L,7608389,7616533,8144
FBgn0040299,Myo28B1,2L,7666047,7689459,23412
FBgn0041181,Tep3,2L,7702805,7710690,7885
FBgn0031941,ATPsynGL,2L,7747275,7747874,599
FBgn0031946,CG7164,2L,7781465,7782760,1295
FBgn0031947,Brd7-9,2L,7782865,7786061,3196
FBgn0031951,r2d2,2L,7800147,7802098,1951
FBgn0031952,Cdc14,2L,7801668,7810703,9035
FBgn0031950,Herp,2L,7796314,7800058,3744
FBgn0031948,CG7149,2L,7786160,7790557,4397
FBgn0031942,CG7203,2L,7752170,7753186,1016
FBgn0031940,CG7214,2L,7743682,7744839,1157
FBgn0014454,Acp1,2L,7740562,7741537,975
FBgn0031939,CG13796,2L,7727157,7732670,5513
FBgn0031937,CG13795,2L,7723045,7726298,3253
FBgn0031936,CG13794,2L,7719847,7722823,2976
FBgn0031935,CG13793,2L,7716974,7719487,2513
FBgn0053296,CG33296,2L,7713998,7716645,2647
FBgn0041182,Tep2,2L,7693727,7701601,7874
FBgn0027515,CG7115,2L,7821151,7825350,4199
FBgn0004177,mts,2L,7827650,7833576,5926
FBgn0031968,CG7231,2L,7983946,7986785,2839
FBgn0031975,Tg,2L,8011405,8026898,15493
FBgn0031977,baf,2L,8029462,8030565,1103
FBgn0044323,Cka,2L,8030721,8040826,10105
FBgn0031979,CCDC53,2L,8041106,8041879,773
FBgn0031981,Megf8,2L,8043471,8054326,10855
FBgn0010287,Trf,2L,8072895,8073948,1053
FBgn0013531,MED20,2L,8071812,8072848,1036
FBgn0011230,poe,2L,8054322,8071624,17302
FBgn0031980,RpL36A,2L,8041873,8042909,1036
FBgn0031976,CG7367,2L,8026914,8039788,12874
FBgn0031974,CG12560,2L,8008302,8009477,1175
FBgn0031973,Spn28Dc,2L,8004548,8007210,2662
FBgn0031972,Wwox,2L,7999670,8004286,4616
FBgn0031970,CG7227,2L,7994388,7998151,3763
FBgn0031969,pes,2L,7986786,7994184,7398
FBgn0031961,CG7102,2L,7883282,7887513,4231
FBgn0031959,spz3,2L,7873495,7879552,6057
FBgn0045038,Proc,2L,7864642,7871432,6790
FBgn0031957,TwdlE,2L,7857957,7860839,2882
FBgn0031955,CG14535,2L,7844905,7855475,10570
FBgn0020618,Rack1,2L,7825347,7827315,1968
FBgn0031986,CG8673,2L,8124329,8125799,1470
FBgn0031988,CG8668,2L,8127001,8133989,6988
FBgn0051606,CG31606,2L,8147611,8148356,745
FBgn0031996,CG8460,2L,8197193,8198813,1620
FBgn0031997,PGAP5,2L,8198882,8200652,1770
FBgn0031999,CG8419,2L,8206171,8209637,3466
FBgn0015299,Ssb-c31a,2L,8211347,8211938,591
FBgn0032002,CG8353,2L,8214045,8215239,1194
FBgn0032008,CG14277,2L,8242486,8243426,940
FBgn0032013,Scgalpha,2L,8303429,8305376,1947
FBgn0032014,CG7840,2L,8305586,8306741,1155
FBgn0032016,Mettl14,2L,8308427,8309961,1534
FBgn0032018,CG7806,2L,8311399,8317011,5612
FBgn0032020,strat,2L,8320328,8321285,957
FBgn0032022,CG14275,2L,8327456,8332911,5455
FBgn0032024,CG14273,2L,8342695,8344378,1683
FBgn0032025,CG7778,2L,8346620,8351112,4492
FBgn0032026,CG7627,2L,8355678,8362469,6791
FBgn0032021,CG7781,2L,8321280,8325409,4129
FBgn0032017,CG7810,2L,8309876,8311195,1319
FBgn0032015,Ostgamma,2L,8306696,8308192,1496
FBgn0003502,Btk,2L,8258373,8301079,42706
FBgn0032010,CG8086,2L,8244160,8257502,13342
FBgn0028987,Spn28F,2L,8240414,8241800,1386
FBgn0032006,Pvr,2L,8220980,8239878,18898
FBgn0032005,Snx6,2L,8218071,8220741,2670
FBgn0032004,CG8292,2L,8216851,8218017,1166
FBgn0032000,CG8372,2L,8212039,8212902,863
FBgn0003607,Su(var)205,2L,8209626,8211122,1496
FBgn0031998,SLC5A11,2L,8200465,8205132,4667
FBgn0031992,Acbp1,2L,8161796,8162452,656
FBgn0031990,PAPLA1,2L,8134247,8159638,25391
FBgn0031987,CG12375,2L,8125668,8126890,1222
FBgn0031985,mon2,2L,8116965,8124010,7045
FBgn0032029,CG17292,2L,8370454,8374250,3796
FBgn0032030,Wdr82,2L,8374461,8375549,1088
FBgn0032032,CG17294,2L,8377035,8378206,1171
FBgn0032034,Rcd4,2L,8382861,8383657,796
FBgn0032036,CG13384,2L,8384455,8388804,4349
FBgn0032040,CG13386,2L,8399021,8400078,1057
FBgn0051898,CG31898,2L,8400421,8401592,1171
FBgn0020497,emb,2L,8403573,8408853,5280
FBgn0027932,Akap200,2L,8415690,8431297,15607
FBgn0051897,CG31897,2L,8442447,8445815,3368
FBgn0032047,CG13088,2L,8488981,8490546,1565
FBgn0032052,PIG-U,2L,8515096,8516755,1659
FBgn0032054,Uba4,2L,8517411,8519176,1765
FBgn0032055,Sgp,2L,8519690,8521809,2119
FBgn0016122,Acer,2L,8521933,8525740,3807
FBgn0028394,CG17834,2L,8529141,8541439,12298
FBgn0011259,Sema1a,2L,8542147,8672041,129894
FBgn0032053,mRpL51,2L,8516753,8517380,627
FBgn0032051,CG13097,2L,8512174,8514868,2694
FBgn0032050,CG13096,2L,8509069,8511866,2797
FBgn0032048,Dh31,2L,8491868,8506845,14977
FBgn0032049,Bace,2L,8494893,8496307,1414
FBgn0026718,Agpat2,2L,8449691,8463994,14303
FBgn0027490,D12,2L,8434058,8437365,3307
FBgn0001137,grk,2L,8431086,8433598,2512
FBgn0032042,CG13398,2L,8412144,8415256,3112
FBgn0014417,Naglu,2L,8408888,8411868,2980
FBgn0001084,fy,2L,8401476,8403280,1804
FBgn0040959,Peritrophin-15a,2L,8395665,8396096,431
FBgn0032033,CG13392,2L,8381821,8382807,986
FBgn0032031,CG13390,2L,8375502,8376797,1295
FBgn0001114,Glt,2L,8672698,8676804,4106
FBgn0032061,CatB,2L,8705572,8707527,1955
FBgn0029123,SoxN,2L,8825645,8829670,4025
FBgn0032069,LManVI,2L,8777661,8781252,3591
FBgn0032068,LManV,2L,8772946,8776263,3317
FBgn0003209,raw,2L,8709880,8740660,30780
FBgn0004914,Hnf4,2L,8687226,8709611,22385
FBgn0032059,PrBP,2L,8684823,8685955,1132
FBgn0032058,CG9289,2L,8681325,8684376,3051
FBgn0032057,CG9287,2L,8676777,8679812,3035
FBgn0032074,Tsp29Fa,2L,8933962,8936096,2134
FBgn0032075,Tsp29Fb,2L,8937390,8939743,2353
FBgn0040963,CG18662,2L,8980659,8981432,773
FBgn0032085,CG9555,2L,8991735,8993632,1897
FBgn0032086,CG17906,2L,8994391,8995617,1226
FBgn0040964,CG18661,2L,8997605,8998544,939
FBgn0015316,Try29F,2L,8998537,8999816,1279
FBgn0032095,Toll-4,2L,9084107,9089440,5333
FBgn0052982,CG32982,2L,9125737,9163721,37984
FBgn0032100,CG13108,2L,9164235,9165426,1191
FBgn0032101,CG9586,2L,9165421,9166514,1093
FBgn0051708,DIP-zeta,2L,9051631,9071164,19533
FBgn0013746,alien,2L,8993818,8997379,3561
FBgn0011705,rost,2L,8985936,8989539,3603
FBgn0032084,CG13101,2L,8977834,8984872,7038
FBgn0032083,CG9541,2L,8970520,8975428,4908
FBgn0032079,CG31886,2L,8953481,8959051,5570
FBgn0032078,C1GalTA,2L,8943455,8951216,7761
FBgn0041092,tai,2L,9166778,9250211,83433
FBgn0032109,CG17005,2L,9327744,9330332,2588
FBgn0010314,Cks30A,2L,9330763,9331981,1218
FBgn0026439,Eaat1,2L,9333567,9341925,8358
FBgn0012036,Aldh,2L,9387389,9391567,4178
FBgn0032116,Mco1,2L,9416588,9426342,9754
FBgn0011232,scat,2L,9431405,9435341,3936
FBgn0032119,CG3769,2L,9435399,9436842,1443
FBgn0032115,CG4438,2L,9396999,9397988,989
FBgn0032105,borr,2L,9251472,9253118,1646
FBgn0002973,numb,2L,9437469,9464184,26715
FBgn0032123,Oatp30B,2L,9521210,9540060,18850
FBgn0032122,CG31883,2L,9528515,9529648,1133
FBgn0032124,CG17855,2L,9540523,9542480,1957
FBgn0032131,CG3841,2L,9589476,9591783,2307
FBgn0019809,gcm2,2L,9608562,9612706,4144
FBgn0040070,Trx2,2L,9613166,9616404,3238
FBgn0032135,GlcAT-S,2L,9616469,9623109,6640
FBgn0032136,Apoltp,2L,9634179,9656026,21847
FBgn0053299,CG33299,2L,9656600,9657424,824
FBgn0011207,pelo,2L,9700810,9708883,8073
FBgn0032138,CG4364,2L,9708921,9711271,2350
FBgn0051710,CG31710,2L,9702442,9705954,3512
FBgn0000273,Pka-C1,2L,9682315,9699297,16982
FBgn0014179,gcm,2L,9579498,9581745,2247
FBgn0051709,CG31709,2L,9578120,9579638,1518
FBgn0028479,Mtpalpha,2L,9573563,9576769,3206
FBgn0032129,jp,2L,9547720,9566750,19030
FBgn0004868,Gdi,2L,9491176,9494876,3700
FBgn0032139,CG13116,2L,9729940,9730945,1005
FBgn0032140,CG13117,2L,9736645,9737949,1304
FBgn0032143,CG4017,2L,9767058,9768727,1669
FBgn0032144,CG17633,2L,9769060,9770409,1349
FBgn0032147,IP3K1,2L,9782384,9788499,6115
FBgn0032149,CG4036,2L,9790882,9791958,1076
FBgn0032169,CG4709,2L,9954325,9956176,1851
FBgn0032170,CG4658,2L,9957132,9960168,3036
FBgn0032172,CG5850,2L,9959248,9963949,4701
FBgn0032171,CG5846,2L,9956175,9957237,1062
FBgn0032168,CG13126,2L,9952072,9954181,2109
FBgn0063449,Uhg2,2L,9893805,9895003,1198
FBgn0025881,snoRNA:Me18S-A1576,2L,9894795,9894907,112
FBgn0063389,snoRNA:Me18S-G1620,2L,9894477,9894544,67
FBgn0063392,snoRNA:U14:30Ea,2L,9894205,9894285,80
FBgn0032150,CG13123,2L,9791961,9793107,1146
FBgn0011291,Taf11,2L,9762424,9763262,838
FBgn0015035,Cyp4e3,2L,9747839,9750071,2232
FBgn0028704,Nckx30C,2L,9711512,9746495,34983
FBgn0000180,bib,2L,9984645,9995538,10893
FBgn0043456,Ndf,2L,10003832,10008889,5057
FBgn0011584,Trp1,2L,10009381,10013170,3789
FBgn0027600,obst-B,2L,10032690,10038954,6264
FBgn0032178,Spn31A,2L,10060816,10063925,3109
FBgn0032187,CG4839,2L,10144776,10156407,11631
FBgn0005593,RpL7,2L,10201004,10202321,1317
FBgn0032194,ath,2L,10211143,10213721,2578
FBgn0032195,Bcs1,2L,10222657,10224447,1790
FBgn0032198,eEF1delta,2L,10232507,10234450,1943
FBgn0032197,ova,2L,10227760,10231692,3932
FBgn0032196,CG5708,2L,10224457,10226808,2351
FBgn0024320,Npc1a,2L,10213812,10221216,7404
FBgn0032193,CG5727,2L,10209853,10210681,828
FBgn0032192,CG5731,2L,10207085,10209744,2659
FBgn0032191,Snx17,2L,10204757,10206961,2204
FBgn0032189,Ripalpha,2L,10199401,10200974,1573
FBgn0028675,Sur,2L,10182557,10199117,16560
FBgn0051874,Fum4,2L,10189820,10191496,1676
FBgn0032181,CG13133,2L,10091208,10092389,1181
FBgn0051755,SoYb,2L,9996706,10002736,6030
FBgn0051875,CG31875,2L,9995561,10002736,7175
FBgn0040965,lncRNA:CR13130,2L,9983671,9984743,1072
FBgn0004419,me31B,2L,10239341,10242172,2831
FBgn0051717,CG31717,2L,10250737,10251714,977
FBgn0010407,Ror,2L,10251843,10254686,2843
FBgn0032204,CG4953,2L,10266703,10268748,2045
FBgn0032205,CG4957,2L,10268872,10269904,1032
FBgn0032214,CG4968,2L,10306922,10308045,1123
FBgn0032217,CG4972,2L,10314792,10317569,2777
FBgn0032219,CG4995,2L,10322476,10324990,2514
FBgn0032222,Cox10,2L,10331471,10333129,1658
FBgn0032223,GATAd,2L,10333734,10339185,5451
FBgn0019932,SamDC,2L,10339457,10341503,2046
FBgn0051715,CG31715,2L,10341616,10342523,907
FBgn0032224,Sps2,2L,10342594,10344223,1629
FBgn0032225,Frmd5,2L,10344442,10347706,3264
FBgn0032229,ClpP,2L,10356795,10358078,1283
FBgn0003087,pim,2L,10362989,10364092,1103
FBgn0032230,lft,2L,10364471,10366410,1939
FBgn0032231,CG5056,2L,10366692,10367946,1254
FBgn0032233,dpr19,2L,10376168,10379905,3737
FBgn0032234,gny,2L,10380103,10382864,2761
FBgn0032235,CG5096,2L,10382263,10384723,2460
FBgn0032236,mRpS7,2L,10386662,10387652,990
FBgn0051716,Cnot4,2L,10396716,10403206,6490
FBgn0051718,Ir31a,2L,10405565,10408197,2632
FBgn0003942,RpS27A,2L,10408352,10410456,2104
FBgn0025366,Ip259,2L,10408352,10409610,1258
FBgn0032243,Klp31E,2L,10414017,10418991,4974
FBgn0032244,RfC3,2L,10419190,10420612,1422
FBgn0032246,Wdfy2,2L,10423291,10425482,2191
FBgn0032247,CG5188,2L,10428829,10429988,1159
FBgn0004915,TfIIB,2L,10431338,10433116,1778
FBgn0032250,holn1,2L,10435995,10437316,1321
FBgn0027052,STUB1,2L,10437548,10439240,1692
FBgn0032251,Nse4,2L,10439440,10441047,1607
FBgn0032252,loh,2L,10442534,10450080,7546
FBgn0027611,LManII,2L,10457658,10462472,4814
FBgn0032256,RluA-2,2L,10477073,10482975,5902
FBgn0026431,Grip75,2L,10483295,10485857,2562
FBgn0032260,CG13144,2L,10489900,10491454,1554
FBgn0032258,Cog4,2L,10485538,10488622,3084
FBgn0051719,RluA-1,2L,10463340,10474349,11009
FBgn0032253,LManI,2L,10452677,10457241,4564
FBgn0032249,TBC1D16,2L,10432687,10435656,2969
FBgn0032248,Bug22,2L,10429920,10430918,998
FBgn0005683,pie,2L,10420625,10422780,2155
FBgn0032242,CG5355,2L,10410537,10413463,2926
FBgn0004106,Cdk1,2L,10384739,10386262,1523
FBgn0053303,CG33303,2L,10373369,10375757,2388
FBgn0027568,Cand1,2L,10358134,10362707,4573
FBgn0032228,CtsL4,2L,10354743,10356597,1854
FBgn0032221,Schip1,2L,10328200,10331116,2916
FBgn0011703,RnrL,2L,10325026,10327943,2917
FBgn0032218,CG5381,2L,10317497,10323102,5605
FBgn0032216,Usp14,2L,10312265,10314396,2131
FBgn0027491,Cdk5alpha,2L,10308131,10310956,2825
FBgn0032213,Sph35,2L,10304069,10306594,2525
FBgn0005322,nmd,2L,10302173,10303947,1774
FBgn0032210,CYLD,2L,10295859,10299847,3988
FBgn0032209,Hand,2L,10292679,10295385,2706
FBgn0032208,Ufd4,2L,10281943,10292365,10422
FBgn0003751,trk,2L,10271443,10272324,881
FBgn0011305,Rsf1,2L,10261795,10263554,1759
FBgn0032200,CG5676,2L,10254610,10255891,1281
FBgn0000229,bsk,2L,10247502,10250501,2999
FBgn0024248,chico,2L,10242512,10247078,4566
FBgn0032261,CG6094,2L,10507081,10508032,951
FBgn0010398,Lrr47,2L,10517335,10519269,1934
FBgn0032264,Lip4,2L,10527572,10531778,4206
FBgn0032265,CG18301,2L,10531821,10533647,1826
FBgn0032266,CG18302,2L,10534322,10536587,2265
FBgn0032268,CG6138,2L,10567255,10568012,757
FBgn0051872,CG31872,2L,10639931,10643539,3608
FBgn0043825,CG18284,2L,10643971,10645891,1920
FBgn0051871,CG31871,2L,10662081,10671487,9406
FBgn0040496,CG17104,2L,10677198,10679707,2509
FBgn0032281,CG17107,2L,10681902,10682528,626
FBgn0032287,CG6415,2L,10703621,10704930,1309
FBgn0032290,CG6443,2L,10728978,10730302,1324
FBgn0032291,CG17118,2L,10730255,10731356,1101
FBgn0032293,Dpy-30L1,2L,10732653,10733307,654
FBgn0032295,CG12299,2L,10737345,10740762,3417
FBgn0027550,CG6495,2L,10761116,10764971,3855
FBgn0015320,Ubc2,2L,10765010,10768006,2996
FBgn0032297,CG17124,2L,10744075,10756325,12250
FBgn0032296,CG6729,2L,10740782,10743935,3153
FBgn0032294,Vha16-5,2L,10736319,10737043,724
FBgn0027868,Nup107,2L,10733293,10736071,2778
FBgn0032292,EMC3,2L,10731400,10732423,1023
FBgn0024740,Lip2,2L,10701940,10709453,7513
FBgn0023496,Lip1,2L,10699408,10701544,2136
FBgn0032286,CG7300,2L,10695000,10698043,3043
FBgn0032285,CG17108,2L,10692940,10694103,1163
FBgn0032284,CG7294,2L,10688734,10689271,537
FBgn0032283,CG7296,2L,10686124,10687066,942
FBgn0032282,CG7299,2L,10683427,10684409,982
FBgn0032271,CG7329,2L,10629352,10638471,9119
FBgn0032269,w-cup,2L,10575860,10577792,1932
FBgn0032262,CG7384,2L,10507859,10510453,2594
FBgn0032299,CG17127,2L,10770868,10771370,502
FBgn0051870,CG31870,2L,10790222,10791450,1228
FBgn0027363,Stam,2L,10858536,10862006,3470
FBgn0032321,YL-1,2L,10970443,10972093,1650
FBgn0032322,CG16743,2L,10972280,10973408,1128
FBgn0041781,SCAR,2L,10976772,10982395,5623
FBgn0026148,CG12253,2L,10987806,10989241,1435
FBgn0026147,TTLL4A,2L,10989401,10997897,8496
FBgn0032330,Samuel,2L,11013206,11066998,53792
FBgn0032329,Art8,2L,11009821,11011086,1265
FBgn0015756,RpL9,2L,11002758,11004189,1431
FBgn0000146,aub,2L,10997819,11001476,3657
FBgn0004872,piwi,2L,10982205,10987420,5215
FBgn0010612,ATPsynG,2L,10975522,10976399,877
FBgn0000018,abo,2L,10973443,10975293,1850
FBgn0053129,Tmem214,2L,10964905,10970275,5370
FBgn0032314,CG7309,2L,10906270,10908893,2623
FBgn0024227,aurB,2L,10856797,10858094,1297
FBgn0027453,Dnz1,2L,10854435,10856644,2209
FBgn0069354,Porin2,2L,10845788,10847044,1256
FBgn0032305,CG6700,2L,10837732,10842597,4865
FBgn0051869,CG31869,2L,10772038,10801109,29071
FBgn0032298,CG6724,2L,10768234,10769952,1718
FBgn0032338,CG16854,2L,11086721,11090973,4252
FBgn0032339,Wdr59,2L,11091444,11095096,3652
FBgn0041246,Gr32a,2L,11114014,11115823,1809
FBgn0032348,CG4751,2L,11130737,11136003,5266
FBgn0040211,hgo,2L,11136393,11138565,2172
FBgn0032354,Boh2,2L,11179032,11180430,1398
FBgn0032358,Ppt2,2L,11280298,11281920,1622
FBgn0020270,mre11,2L,11282090,11284335,2245
FBgn0040232,cmet,2L,11261026,11269002,7976
FBgn0014076,Vm32E,2L,11171167,11171665,498
FBgn0032350,CG6287,2L,11151506,11155721,4215
FBgn0010197,Gyc32E,2L,11138759,11149101,10342
FBgn0028700,RfC38,2L,11128932,11130645,1713
FBgn0032346,Csl4,2L,11122574,11123567,993
FBgn0032345,Dnaaf4,2L,11120642,11121714,1072
FBgn0027582,CG6230,2L,11115635,11120319,4684
FBgn0032343,Idua,2L,11110557,11113061,2504
FBgn0032341,Reps,2L,11100963,11106645,5682
FBgn0032337,AstCC,2L,11083459,11085229,1770
FBgn0032336,AstC,2L,11076165,11081399,5234
FBgn0000287,salr,2L,11358873,11373636,14763
FBgn0003313,sala,2L,11484707,11486949,2242
FBgn0032362,spz4,2L,11501715,11508649,6934
FBgn0051706,CG31706,2L,11529038,11531052,2014
FBgn0028490,CG31705,2L,11523021,11528205,5184
FBgn0032363,Dlg5,2L,11508399,11517081,8682
FBgn0032360,CG14926,2L,11342301,11343318,1017
FBgn0015400,kek2,2L,11581937,11626883,44946
FBgn0032371,CG4983,2L,11652448,11654164,1716
FBgn0032372,CG4988,2L,11694804,11696107,1303
FBgn0032378,CycY,2L,11810092,11813780,3688
FBgn0020309,crol,2L,11794327,11809438,15111
FBgn0032377,CG14937,2L,11792412,11794086,1674
FBgn0028412,Mst33A,2L,11585433,11586833,1400
FBgn0051704,CG31704,2L,11840691,11841204,513
FBgn0040968,CG14933,2L,11842828,11844012,1184
FBgn0032381,Mal-B1,2L,11847226,11849169,1943
FBgn0032382,Mal-B2,2L,11849958,11852881,2923
FBgn0026390,Or33c,2L,11937969,11939202,1233
FBgn0005664,Crys,2L,11944129,11947131,3002
FBgn0032387,CG16965,2L,11981591,11984380,2789
FBgn0032390,dgt2,2L,11989936,11990979,1043
FBgn0051866,Ada1-2,2L,11992902,11994054,1152
FBgn0051864,Qtzl,2L,11995740,11996723,983
FBgn0051865,Ada1-1,2L,11996809,11997965,1156
FBgn0032393,Nfs1,2L,11999654,12001244,1590
FBgn0014019,Rh5,2L,12008153,12009832,1679
FBgn0010497,dmGlut,2L,12027438,12034122,6684
FBgn0032402,PLCXD,2L,12049418,12052049,2631
FBgn0032404,RpL7-like,2L,12056326,12058251,1925
FBgn0032406,CG14947,2L,12076100,12077739,1639
FBgn0027505,Rab3-GAP,2L,12058304,12063184,4880
FBgn0032401,Plzf,2L,12046711,12048918,2207
FBgn0032400,CG6770,2L,12045343,12046118,775
FBgn0032399,CG6785,2L,12041054,12045200,4146
FBgn0032398,CG6766,2L,12038631,12040689,2058
FBgn0032397,Tom70,2L,12035984,12038511,2527
FBgn0032395,Wdr81,2L,12014304,12020960,6656
FBgn0032394,Hacd1,2L,12001234,12002266,1032
FBgn0042125,CG18787,2L,11997900,11999340,1440
FBgn0042127,CG18789,2L,11993989,11995432,1443
FBgn0000588,esc,2L,11827204,11829405,2201
FBgn0032407,Pex19,2L,12091822,12095250,3428
FBgn0028707,Mt2,2L,12096525,12097687,1162
FBgn0032409,Ced-12,2L,12097838,12100839,3001
FBgn0027081,ThrRS,2L,12103751,12107170,3419
FBgn0032414,CG17211,2L,12114360,12129896,15536
FBgn0032416,Gr33a,2L,12138008,12140392,2384
FBgn0051760,CG31760,2L,12142780,12170508,27728
FBgn0051861,CG31861,2L,12161767,12162605,838
FBgn0051860,ZnT33D,2L,12164241,12166704,2463
FBgn0032421,crok,2L,12172981,12174091,1110
FBgn0000114,bru1,2L,12175004,12313438,138434
FBgn0051759,CG31759,2L,12207709,12210110,2401
FBgn0032424,CG17010,2L,12356441,12357906,1465
FBgn0032422,atilla,2L,12175451,12177886,2435
FBgn0032420,CG6583,2L,12171204,12172586,1382
FBgn0032415,rho-6,2L,12130516,12133411,2895
FBgn0015797,Rab6,2L,12107221,12109116,1895
FBgn0029137,Patsas,2L,12100765,12103285,2520
FBgn0032408,CG6712,2L,12095176,12096511,1335
FBgn0041195,Pkd2,2L,12398274,12402023,3749
FBgn0032428,Fam92,2L,12424904,12426440,1536
FBgn0032430,Trm1,2L,12428028,12430021,1993
FBgn0020443,eRF3,2L,12434452,12441279,6827
FBgn0032436,CG5418,2L,12451945,12453242,1297
FBgn0032434,CG5421,2L,12446080,12448132,2052
FBgn0032433,Oatp33Ea,2L,12441401,12445924,4523
FBgn0032431,CG5435,2L,12429827,12430892,1065
FBgn0032429,CG5446,2L,12426631,12427709,1078
FBgn0004394,pdm2,2L,12657165,12686306,29141
FBgn0032445,CG6153,2L,12692993,12693939,946
FBgn0032447,PICK1,2L,12695033,12698917,3884
FBgn0032451,spict,2L,12704725,12706683,1958
FBgn0032453,CG6180,2L,12707661,12708680,1019
FBgn0015399,kek1,2L,12817000,12822787,5787
FBgn0032454,CG5787,2L,12708792,12712952,4160
FBgn0032452,CG15484,2L,12706799,12707711,912
FBgn0032450,CG5776,2L,12700949,12704451,3502
FBgn0032449,CG17036,2L,12698918,12700746,1828
FBgn0032446,IFT43,2L,12693872,12694988,1116
FBgn0032444,CCT4,2L,12690336,12692934,2598
FBgn0040509,ACXB,2L,12916814,12921008,4194
FBgn0040510,ACXA,2L,12921091,12925453,4362
FBgn0032464,Vha68-3,2L,12978786,12981293,2507
FBgn0021796,mTor,2L,13004480,13013197,8717
FBgn0032470,Ttc30,2L,13106807,13109468,2661
FBgn0028965,CG9933,2L,13019575,13021312,1737
FBgn0032467,Ube4B,2L,13013276,13019434,6158
FBgn0032465,Yip1d1,2L,12993757,13000635,6878
FBgn0032471,CG5122,2L,13130591,13134804,4213
FBgn0032473,kmg,2L,13160527,13163153,2626
FBgn0024291,Sirt1,2L,13165564,13169551,3987
FBgn0032476,CG5439,2L,13177150,13178978,1828
FBgn0032477,Alg7,2L,13179247,13183495,4248
FBgn0032478,Rsph1,2L,13183450,13184875,1425
FBgn0032480,Edem2,2L,13192201,13197281,5080
FBgn0032482,Pect,2L,13203762,13210828,7066
FBgn0004192,snRNA:U2:34ABb,2L,13215839,13216030,191
FBgn0032486,mRF1,2L,13219979,13221398,1419
FBgn0032488,CG16812,2L,13222587,13224545,1958
FBgn0027586,Jhbp14,2L,13236494,13239297,2803
FBgn0032494,Jhbp13,2L,13239989,13241773,1784
FBgn0003935,snRNA:U5:34A,2L,13244848,13244974,126
FBgn0032495,CG16820,2L,13246232,13250189,3957
FBgn0032499,Uvrag,2L,13286777,13289556,2779
FBgn0051729,CG31729,2L,13289997,13301668,11671
FBgn0032503,CG16825,2L,13304788,13307807,3019
FBgn0032505,CG16826,2L,13347773,13349020,1247
FBgn0032509,Grx3,2L,13366447,13367410,963
FBgn0051852,Tap42,2L,13367617,13369021,1404
FBgn0051855,CG31855,2L,13369204,13370329,1125
FBgn0032513,Stard7,2L,13374019,13376404,2385
FBgn0025724,beta'COP,2L,13378902,13382382,3480
FBgn0032514,CG9302,2L,13376455,13378538,2083
FBgn0032512,Bdp1,2L,13371427,13373890,2463
FBgn0032511,ND-B22,2L,13370103,13371110,1007
FBgn0022069,Nnp-1,2L,13363308,13366189,2881
FBgn0032507,CG9377,2L,13359901,13361565,1664
FBgn0032506,CG9395,2L,13349823,13355073,5250
FBgn0028406,Drep4,2L,13283912,13286462,2550
FBgn0032493,Mabi,2L,13233798,13234660,862
FBgn0032487,Ski6,2L,13221397,13222429,1032
FBgn0032485,CG9426,2L,13216290,13219923,3633
FBgn0032484,kek4,2L,13212335,13215350,3015
FBgn0032483,CG15482,2L,13210773,13211814,1041
FBgn0032481,CG16972,2L,13197102,13203295,6193
FBgn0032479,CG16974,2L,13183849,13191979,8130
FBgn0051849,Mgat3,2L,13180398,13182596,2198
FBgn0032475,Sfmbt,2L,13169649,13176785,7136
FBgn0032474,DnaJ-H,2L,13163209,13166072,2863
FBgn0040972,CG16978,2L,13143214,13143622,408
FBgn0032472,CG9928,2L,13142445,13142903,458
FBgn0032517,CG7099,2L,13387571,13393959,6388
FBgn0032521,CG7110,2L,13398991,13411047,12056
FBgn0026760,Tehao,2L,13435622,13439930,4308
FBgn0028546,ics,2L,13639447,13642602,3155
FBgn0028513,CG9254,2L,13595503,13597186,1683
FBgn0023407,B4,2L,13500624,13549328,48704
FBgn0032530,CG9263,2L,13541638,13542576,938
FBgn0032525,Hsp60D,2L,13447538,13449497,1959
FBgn0032524,Hacd2,2L,13444103,13445651,1548
FBgn0032520,CG10859,2L,13396392,13398664,2272
FBgn0032518,RpL24,2L,13393687,13395131,1444
FBgn0032516,Ing5,2L,13385848,13387312,1464
FBgn0028527,CG18507,2L,13665525,13672967,7442
FBgn0028848,Gpo3,2L,13708215,13710583,2368
FBgn0028541,TM9SF4,2L,13746952,13773905,26953
FBgn0051845,asRNA:CR31845,2L,13777195,13778124,929
FBgn0024846,p38b,2L,13780689,13782611,1922
FBgn0028539,Eato,2L,13784084,13790562,6478
FBgn0028931,CG16863,2L,13790959,13793264,2305
FBgn0028538,Sec71,2L,13793521,13799674,6153
FBgn0027844,CAH1,2L,13803626,13809994,6368
FBgn0028919,CG16865,2L,13811522,13813316,1794
FBgn0001965,Sos,2L,13813816,13819824,6008
FBgn0015271,Orc5,2L,13829837,13831576,1739
FBgn0026373,Polr2C,2L,13833337,13834306,969
FBgn0028509,CenG1A,2L,13835564,13898712,63148
FBgn0028534,CG7916,2L,13846752,13847799,1047
FBgn0012037,Ance,2L,13905645,13909212,3567
FBgn0032535,Ance-2,2L,13909333,13911719,2386
FBgn0028544,Vajk3,2L,13944756,13947476,2720
FBgn0028938,Vajk1,2L,13920707,13923553,2846
FBgn0019890,Smg5,2L,13898828,13904661,5833
FBgn0028920,CG8997,2L,13843915,13845325,1410
FBgn0053307,CG33307,2L,13839262,13841520,2258
FBgn0001961,Arpc1,2L,13827941,13829741,1800
FBgn0004406,PolG1,2L,13823980,13827772,3792
FBgn0032533,CG16888,2L,13812700,13813256,556
FBgn0028658,Adat1,2L,13808360,13811474,3114
FBgn0028932,CG16890,2L,13782231,13784338,2107
FBgn0028847,CG9014,2L,13722161,13723642,1481
FBgn0051814,DIP-kappa,2L,13676860,13717320,40460
FBgn0027929,NimB1,2L,13963507,13965088,1581
FBgn0028936,NimB5,2L,13970177,13972173,1996
FBgn0028940,Cyp28a5,2L,13977302,13979569,2267
FBgn0028939,NimC2,2L,13980126,13983269,3143
FBgn0027348,bgm,2L,14013004,14019328,6324
FBgn0028875,nAChRalpha5,2L,14040170,14094401,54231
FBgn0051769,CG31769,2L,14109597,14110739,1142
FBgn0028526,CG15293,2L,14108057,14109447,1390
FBgn0001967,NimC3,2L,14019357,14020208,851
FBgn0003255,rk,2L,13982743,14001248,18505
FBgn0028430,He,2L,13972096,13972947,851
FBgn0028542,NimB4,2L,13968280,13969976,1696
FBgn0028543,NimB2,2L,13965012,13967018,2006
FBgn0028916,CG33090,2L,14334158,14345795,11637
FBgn0028531,CG15286,2L,14338240,14340080,1840
FBgn0015791,Rab14,2L,14355145,14358764,3619
FBgn0001970,Pgant35A,2L,14359252,14361411,2159
FBgn0004858,elB,2L,14390628,14409549,18921
FBgn0020258,ppk,2L,14378218,14381172,2954
FBgn0028530,mTTF,2L,14347239,14348790,1551
FBgn0005771,noc,2L,14490859,14494019,3160
FBgn0028855,CG15282,2L,14712471,14713298,827
FBgn0028870,CG4691,2L,14760767,14761924,1157
FBgn0028868,CG4701,2L,14765908,14767225,1317
FBgn0028887,CG3491,2L,14924590,14930565,5975
FBgn0013301,ProtB,2L,14882101,14883721,1620
FBgn0013300,ProtA,2L,14879050,14881652,2602
FBgn0028886,CG15279,2L,14844993,14851749,6756
FBgn0028866,CG18420,2L,14794516,14796642,2126
FBgn0032549,CG4650,2L,14773814,14774981,1167
FBgn0028537,CG31775,2L,14737090,14737769,679
FBgn0040228,DCTN5-p25,2L,15005733,15006607,874
FBgn0028926,NC2beta,2L,15007813,15008538,725
FBgn0260446,GABA-B-R1,2L,15016331,15034704,18373
FBgn0053310,CG33310,2L,15026882,15029513,2631
FBgn0041713,yellow-c,2L,15035394,15037841,2447
FBgn0004837,Su(H),2L,15039488,15043334,3846
FBgn0028879,wwk,2L,15074776,15096915,22139
FBgn0001978,stc,2L,15113480,15118069,4589
FBgn0028862,dao,2L,15248879,15254715,5836
FBgn0028516,ZnT35C,2L,15228728,15247714,18986
FBgn0028888,CG4168,2L,15161882,15200459,38577
FBgn0024183,vig,2L,15062931,15070316,7385
FBgn0010422,TfIIS,2L,15058919,15060757,1838
FBgn0000317,ck,2L,15044963,15057862,12899
FBgn0001977,CIAPIN1,2L,15036293,15038861,2568
FBgn0051832,CG31832,2L,15030928,15031750,822
FBgn0028853,CG15263,2L,15285000,15286047,1047
FBgn0028880,CG15256,2L,15550372,15552029,1657
FBgn0028370,kek3,2L,15552723,15583978,31255
FBgn0028864,CG18477,2L,15661041,15662753,1712
FBgn0051780,CG31780,2L,15696038,15697750,1712
FBgn0001986,Mtr4,2L,15752263,15755900,3637
FBgn0028507,CG3793,2L,15764220,15766267,2047
FBgn0051826,CG31826,2L,15771263,15773113,1850
FBgn0041627,Ku80,2L,15768630,15771159,2529
FBgn0001990,wek,2L,15766133,15768349,2216
FBgn0001987,Gli,2L,15756002,15762758,6756
FBgn0001989,ND-B17,2L,15749319,15751078,1759
FBgn0028863,stol,2L,15644183,15718272,74089
FBgn0028901,t-Grip91,2L,15784085,15790146,6061
FBgn0028902,Tektin-A,2L,15854126,15856450,2324
FBgn0028857,CG12448,2L,15941441,15942854,1413
FBgn0028856,CG18063,2L,15957858,15959431,1573
FBgn0028644,beat-Ic,2L,16000291,16041703,41412
FBgn0045827,CG13245,2L,16004325,16005461,1136
FBgn0013433,beat-Ia,2L,16049965,16081684,31719
FBgn0051820,CG31820,2L,16005789,16006279,490
FBgn0028645,beat-Ib,2L,15905134,15962435,57301
FBgn0051823,CG31823,2L,15898879,15900524,1645
FBgn0041183,Tep1,2L,15888640,15893811,5171
FBgn0028893,CG31819,2L,16211459,16213304,1845
FBgn0028515,EndoGI,2L,16257688,16259511,1823
FBgn0028897,CG4935,2L,16262141,16263483,1342
FBgn0040079,pkaap,2L,16288290,16291195,2905
FBgn0028896,CG17329,2L,16291284,16291948,664
FBgn0001992,Cyp303a1,2L,16294183,16296969,2786
FBgn0028895,CG17328,2L,16299943,16301765,1822
FBgn0028525,c(2)M,2L,16303264,16305940,2676
FBgn0011708,Syx5,2L,16307346,16309274,1928
FBgn0001086,fzy,2L,16310956,16313097,2141
FBgn0014092,CG4278,2L,16327069,16328131,1062
FBgn0028506,CG4455,2L,16352934,16354539,1605
FBgn0025678,CaBP1,2L,16354886,16356735,1849
FBgn0000307,chif,2L,16342430,16352628,10198
FBgn0028899,CG31817,2L,16330560,16337885,7325
FBgn0001995,mRpL4,2L,16328059,16329132,1073
FBgn0000250,cact,2L,16313036,16326207,13171
FBgn0000339,cni,2L,16309292,16310726,1434
FBgn0015338,CG5861,2L,16305801,16307298,1497
FBgn0028894,GMF,2L,16301656,16302954,1298
FBgn0028375,heix,2L,16296051,16299858,3807
FBgn0032582,CG13258,2L,16292010,16293025,1015
FBgn0001994,crp,2L,16263556,16287730,24174
FBgn0002673,twe,2L,16259414,16261877,2463
FBgn0024734,PRL-1,2L,16245835,16257606,11771
FBgn0020416,Idgf1,2L,16445278,16446793,1515
FBgn0020415,Idgf2,2L,16447330,16450508,3178
FBgn0020414,Idgf3,2L,16450907,16455194,4287
FBgn0032585,Nepl8,2L,16488148,16490182,2034
FBgn0032586,Tpr2,2L,16491540,16507621,16081
FBgn0051815,CG31815,2L,16605822,16607321,1499
FBgn0032590,CG4631,2L,16607370,16610037,2667
FBgn0032587,CG5953,2L,16508078,16532877,24799
FBgn0028523,CG5888,2L,16400175,16448469,48294
FBgn0001185,her,2L,16677185,16679691,2506
FBgn0051812,Tsen2,2L,16729777,16731199,1422
FBgn0032597,Nubp1,2L,16732550,16733624,1074
FBgn0032598,ChLD3,2L,16738850,16742610,3760
FBgn0032600,BuGZ,2L,16743405,16753704,10299
FBgn0032601,yellow-b,2L,16754336,16758283,3947
FBgn0032603,CG17928,2L,16791568,16793444,1876
FBgn0040262,Ugt37C2,2L,16794211,16796009,1798
FBgn0040261,Ugt37E1,2L,16796595,16798273,1678
FBgn0040260,Ugt37D1,2L,16799025,16801584,2559
FBgn0004797,mdy,2L,16816660,16826964,10304
FBgn0051739,AspRS-m,2L,16827078,16832093,5015
FBgn0051781,lncRNA:CR31781,2L,16869346,16878300,8954
FBgn0032615,CG6012,2L,16860029,16861489,1460
FBgn0051809,CG31809,2L,16853620,16858714,5094
FBgn0051810,CG31810,2L,16849018,16852368,3350
FBgn0032614,CG13284,2L,16842300,16848716,6416
FBgn0032613,Nepl9,2L,16835136,16837258,2122
FBgn0032612,CG13282,2L,16832065,16834502,2437
FBgn0022213,Cse1,2L,16821156,16825207,4051
FBgn0032609,CG13280,2L,16802026,16821093,19067
FBgn0032602,ppk17,2L,16758184,16760554,2370
FBgn0015391,glu,2L,16733617,16738388,4771
FBgn0032596,Prosbeta4,2L,16731180,16732133,953
FBgn0032595,CG17996,2L,16730458,16731039,581
FBgn0027779,VhaSFD,2L,16722883,16727826,4943
FBgn0062978,CG31808,2L,16704286,16716195,11909
FBgn0051807,CG31807,2L,16681819,16684008,2189
FBgn0032593,Trpgamma,2L,16663454,16676701,13247
FBgn0032618,CG31743,2L,16879517,16886319,6802
FBgn0053179,beat-IIIb,2L,16973091,16993984,20893
FBgn0051806,CG31806,2L,16984978,16985634,656
FBgn0032625,CG15136,2L,17047161,17048281,1120
FBgn0032624,CG6304,2L,17011476,17014700,3224
FBgn0026150,ApepP,2L,16908229,16910418,2189
FBgn0032620,CG12288,2L,16900535,16902218,1683
FBgn0051805,CG31805,2L,16898175,16900473,2298
FBgn0040985,osi,2L,16887109,16887966,857
FBgn0052832,CG32832,2L,16878326,16879290,964
FBgn0045486,Gr36b,2L,17178772,17180064,1292
FBgn0045485,Gr36c,2L,17180338,17181632,1294
FBgn0032633,Lrch,2L,17367511,17384115,16604
FBgn0032632,CG6380,2L,17291075,17292202,1127
FBgn0032629,beat-IIIc,2L,17187637,17260734,73097
FBgn0020503,CLIP-190,2L,17384700,17409698,24998
FBgn0032635,CG15141,2L,17410641,17413499,2858
FBgn0032636,CG5043,2L,17433862,17435800,1938
FBgn0032637,CG5050,2L,17452924,17458775,5851
FBgn0032640,Sgt,2L,17471603,17474773,3170
FBgn0032642,Lamtor3,2L,17481231,17482037,806
FBgn0032644,CG5131,2L,17484501,17485624,1123
FBgn0013810,Dhc36C,2L,17501401,17525515,24114
FBgn0032651,Oli,2L,17589184,17591267,2083
FBgn0032652,CG6870,2L,17591315,17592299,984
FBgn0032650,CG7094,2L,17554354,17555765,1411
FBgn0032649,CG15145,2L,17529311,17532234,2923
FBgn0032648,CG15144,2L,17525585,17529122,3537
FBgn0032647,CG15143,2L,17520892,17524549,3657
FBgn0032646,mEFTs,2L,17499268,17501106,1838
FBgn0003187,qua,2L,17486806,17497208,10402
FBgn0032643,GCS2beta,2L,17481988,17484307,2319
FBgn0024689,fws,2L,17478442,17481029,2587
FBgn0000183,BicD,2L,17459605,17473215,13610
FBgn0032639,CG18563,2L,17456670,17458044,1374
FBgn0032638,SPH93,2L,17454263,17455923,1660
FBgn0011274,Dif,2L,17413248,17433161,19913
FBgn0051803,Rsph9,2L,17411649,17412633,984
FBgn0032634,Polr2J,2L,17409698,17410406,708
FBgn0032656,CG5674,2L,17963379,17974868,11489
FBgn0051740,CG31740,2L,18008953,18009694,741
FBgn0000120,Arr1,2L,18078269,18081307,3038
FBgn0002939,ninaD,2L,18081628,18083608,1980
FBgn0032665,CG15152,2L,18114547,18115220,673
FBgn0041184,Socs36E,2L,18138675,18152417,13742
FBgn0032660,elfless,2L,18009643,18011475,1832
FBgn0023096,btv,2L,17962625,17982472,19847
FBgn0032669,CG15155,2L,18154851,18155942,1091
FBgn0032670,CG5783,2L,18156043,18157162,1119
FBgn0032677,CG5790,2L,18294840,18297347,2507
FBgn0000636,Fas3,2L,18320102,18393441,73339
FBgn0011559,Acp36DE,2L,18356047,18359028,2981
FBgn0051788,CG31788,2L,18257494,18257978,484
FBgn0051802,CG31802,2L,18208415,18209237,822
FBgn0032671,JMJD4,2L,18157110,18159272,2162
FBgn0032682,grnd,2L,18485417,18488021,2604
FBgn0032684,Ugt301D1,2L,18509560,18513512,3952
FBgn0032685,CG10211,2L,18517487,18531967,14480
FBgn0032688,CG15160,2L,18590891,18595429,4538
FBgn0032690,CG10333,2L,18606832,18609550,2718
FBgn0032694,MESR3,2L,18617256,18661776,44520
FBgn0032692,IFT46,2L,18614339,18616106,1767
FBgn0032691,Atac2,2L,18609576,18612249,2673
FBgn0032689,CG10413,2L,18599755,18605249,5494
FBgn0032683,kon,2L,18487747,18503978,16231
FBgn0032681,CG10283,2L,18472964,18484513,11549
FBgn0032698,CG10336,2L,18689528,18690906,1378
FBgn0032700,CG10338,2L,18695664,18698571,2907
FBgn0032701,CG10341,2L,18698714,18700645,1931
FBgn0032703,CG10343,2L,18703473,18704454,981
FBgn0032705,Grip71,2L,18708846,18711297,2451
FBgn0040993,CG17325,2L,18812648,18813941,1293
FBgn0027074,Ugt36F1,2L,18819344,18822573,3229
FBgn0032713,Ugt36D1,2L,18823548,18826716,3168
FBgn0027070,Ugt36E1,2L,18826770,18829059,2289
FBgn0015808,ScpX,2L,18831229,18833630,2401
FBgn0032719,CG17321,2L,18845184,18855110,9926
FBgn0003896,tup,2L,18859507,18881261,21754
FBgn0053120,CG33120,2L,18841400,18844579,3179
FBgn0051752,CG31752,2L,18839628,18841310,1682
FBgn0032717,CG10600,2L,18833710,18839679,5969
FBgn0032715,CG17597,2L,18829012,18831153,2141
FBgn0040992,CG10570,2L,18808694,18811252,2558
FBgn0045852,ham,2L,18762874,18792906,30032
FBgn0032707,CG10348,2L,18714453,18732524,18071
FBgn0032706,Irk3,2L,18711071,18713748,2677
FBgn0025608,Faf2,2L,18706010,18708688,2678
FBgn0032704,Jwa,2L,18704570,18705703,1133
FBgn0032702,CG10376,2L,18700606,18703105,2499
FBgn0005617,msl-1,2L,18683720,18688800,5080
FBgn0015553,tos,2L,18679631,18682075,2444
FBgn0032724,CG10428,2L,18948884,18950973,2089
FBgn0032728,Tango6,2L,18969028,18972004,2976
FBgn0032730,CG10431,2L,18974710,18978187,3477
FBgn0032732,EMC5,2L,18987707,18988331,624
FBgn0032734,CG15169,2L,18991020,18992409,1389
FBgn0051793,CG31793,2L,19003367,19008234,4867
FBgn0032740,CG15172,2L,19022417,19023646,1229
FBgn0032741,Sidpn,2L,19027710,19030780,3070
FBgn0002022,Catsup,2L,19041862,19043614,1752
FBgn0032746,CG10470,2L,19049076,19049884,808
FBgn0032748,CG10492,2L,19054078,19058821,4743
FBgn0032749,Phlpp,2L,19059129,19063132,4003
FBgn0032750,Dus4,2L,19063295,19064726,1431
FBgn0032751,CG17343,2L,19064929,19069673,4744
FBgn0032755,CG17344,2L,19102044,19102909,865
FBgn0000075,amd,2L,19110154,19114110,3956
FBgn0002036,CG10561,2L,19114401,19116570,2169
FBgn0010300,brat,2L,19133816,19179758,45942
FBgn0002031,Phb1,2L,19121345,19123869,2524
FBgn0000422,Ddc,2L,19116483,19120306,3823
FBgn0002023,Lim3,2L,19079256,19108427,29171
FBgn0032753,CG17572,2L,19071131,19074149,3018
FBgn0032752,CG10702,2L,19064832,19069851,5019
FBgn0002021,l(2)37Bb,2L,19049843,19051612,1769
FBgn0032744,Ttc19,2L,19043535,19045148,1613
FBgn0051800,CG31800,2L,19033657,19034576,919
FBgn0001202,hook,2L,19030844,19033498,2654
FBgn0046302,CG10650,2L,18993360,18995934,2574
FBgn0032733,CG15170,2L,18988268,18990233,1965
FBgn0032731,Swip-1,2L,18977519,18987280,9761
FBgn0032729,L2HGDH,2L,18971993,18974448,2455
FBgn0015772,Nak,2L,18957732,18968744,11012
FBgn0032727,Bhmt,2L,18955481,18957311,1830
FBgn0032726,CG10621,2L,18952206,18954431,2225
FBgn0032725,Nedd8,2L,18951006,18951837,831
FBgn0032723,ssp3,2L,18916347,18943960,27613
FBgn0010309,pigeon,2L,19186043,19189938,3895
FBgn0015380,drl,2L,19190342,19208621,18279
FBgn0032769,CG10750,2L,19300255,19301600,1345
FBgn0032770,CG13086,2L,19364375,19365470,1095
FBgn0032771,CG17349,2L,19370445,19372711,2266
FBgn0032772,CG17350,2L,19380930,19383093,2163
FBgn0051798,CG31798,2L,19394160,19396190,2030
FBgn0016675,Lectin-galC1,2L,19417447,19418274,827
FBgn0032780,CG13085,2L,19424050,19430270,6220
FBgn0032779,Alp12,2L,19424050,19429224,5174
FBgn0032781,RtcB,2L,19430643,19432444,1801
FBgn0032782,Rab9,2L,19432574,19435841,3267
FBgn0032783,CG10237,2L,19435850,19442727,6877
FBgn0032775,CG17544,2L,19390370,19398493,8123
FBgn0032774,CG17549,2L,19387050,19390075,3025
FBgn0032773,fon,2L,19383138,19386205,3067
FBgn0024245,dnt,2L,19338669,19363227,24558
FBgn0032768,CG17564,2L,19298345,19299933,1588
FBgn0003346,RanGAP,2L,19441959,19447317,5358
FBgn0032785,CG10026,2L,19454256,19457723,3467
FBgn0000964,tj,2L,19464267,19467758,3491
FBgn0032791,CG18094,2L,19490262,19491679,1417
FBgn0002044,swm,2L,19493251,19497978,4727
FBgn0040268,Top3alpha,2L,19498168,19502268,4100
FBgn0032798,CG10132,2L,19518824,19525453,6629
FBgn0032800,Cep104,2L,19526686,19532985,6299
FBgn0053116,CG33116,2L,19533479,19537363,3884
FBgn0051697,CG31697,2L,19535448,19536104,656
FBgn0032803,CG13082,2L,19538425,19539740,1315
FBgn0041180,Tep4,2L,19548507,19556451,7944
FBgn0032810,CG13077,2L,19565863,19567359,1496
FBgn0027949,msb1l,2L,19577701,19579131,1430
FBgn0032814,CG10366,2L,19584235,19586440,2205
FBgn0000464,Lar,2L,19586623,19732069,145446
FBgn0005590,scw,2L,19699379,19700968,1589
FBgn0032813,PCNA2,2L,19582823,19583990,1167
FBgn0032811,Pmvk,2L,19579093,19580351,1258
FBgn0032805,CG10337,2L,19545376,19546959,1583
FBgn0032801,CG10165,2L,19526910,19530305,3395
FBgn0032799,Dpm1,2L,19525434,19526368,934
FBgn0032797,Hasp,2L,19508953,19517204,8251
FBgn0032796,cyst,2L,19502335,19508764,6429
FBgn0032793,Ctu2,2L,19491647,19493253,1606
FBgn0032790,CG10194,2L,19488682,19490104,1422
FBgn0032787,CG10195,2L,19482232,19484705,2473
FBgn0024230,Hs2st,2L,19442833,19444750,1917
FBgn0032816,Nf-YB,2L,19736044,19737088,1044
FBgn0032819,Dus3,2L,19758879,19760986,2107
FBgn0032822,CG10466,2L,19792104,19792782,678
FBgn0032833,COX4,2L,19958713,19960065,1352
FBgn0032835,CG16772,2L,19962679,19963844,1165
FBgn0032836,CG10680,2L,19964136,19965702,1566
FBgn0014000,Hf,2L,19966727,19967685,958
FBgn0042129,OS9,2L,19965664,19966510,846
FBgn0032834,CG13965,2L,19961758,19962352,594
FBgn0003922,snRNA:U2:38ABa,2L,19815614,19815805,191
FBgn0032824,CG13962,2L,19813704,19814532,828
FBgn0004811,fs(2)ltoPP43,2L,19792773,19795851,3078
FBgn0032821,CdGAPr,2L,19774874,19791882,17008
FBgn0032820,Fbp,2L,19761587,19764136,2549
FBgn0032818,CG10628,2L,19757245,19758615,1370
FBgn0032817,CG10631,2L,19742817,19756904,14087
FBgn0032840,sNPF,2L,20027915,20056373,28458
FBgn0019686,lok,2L,20061422,20064381,2959
FBgn0045064,bwa,2L,20066391,20073719,7328
FBgn0004374,neb,2L,20075757,20089698,13941
FBgn0032846,Pyroxd1,2L,20091435,20093152,1717
FBgn0032848,nesd,2L,20093972,20096253,2281
FBgn0032850,Kua,2L,20097581,20103375,5794
FBgn0032849,mRpS18B,2L,20096329,20097253,924
FBgn0032847,Taf13,2L,20093088,20093849,761
FBgn0032845,CG10747,2L,20089636,20091348,1712
FBgn0032843,CG10730,2L,20070081,20072195,2114
FBgn0003978,vls,2L,20064261,20065679,1418
FBgn0014127,barr,2L,20058163,20061370,3207
FBgn0003475,spir,2L,20311219,20348386,37167
FBgn0015803,RtGEF,2L,20350434,20365254,14820
FBgn0032857,CG10947,2L,20385293,20414800,29507
FBgn0032856,CG16798,2L,20376981,20382356,5375
FBgn0026756,Ugt37A1,2L,20372409,20374104,1695
FBgn0011638,La,2L,20348393,20350012,1619
FBgn0032867,CG15475,2L,20614522,20615559,1037
FBgn0032870,CG2608,2L,20645822,20647381,1559
FBgn0042133,CG18810,2L,20648912,20650079,1167
FBgn0032871,CG2611,2L,20650189,20650898,709
FBgn0032873,CG2614,2L,20656426,20659218,2792
FBgn0032877,CG2617,2L,20682368,20683629,1261
FBgn0032880,TM9SF2,2L,20730416,20734309,3893
FBgn0032879,CarT,2L,20727151,20730282,3131
FBgn0014859,Hr38,2L,20683462,20714588,31126
FBgn0032876,Cen,2L,20678921,20681846,2925
FBgn0051678,CG31678,2L,20659132,20675941,16809
FBgn0016054,phr6-4,2L,20643351,20645791,2440
FBgn0032869,CG17470,2L,20642306,20643244,938
FBgn0032882,Ns4,2L,20752476,20754655,2179
FBgn0011202,dia,2L,20758144,20768053,9909
FBgn0000251,cad,2L,20770731,20783135,12404
FBgn0032884,Pomp,2L,20787656,20789098,1442
FBgn0032886,CG9328,2L,20797715,20814331,16616
FBgn0032889,CG9331,2L,20822828,20827744,4916
FBgn0051673,CG31673,2L,20829609,20831161,1552
FBgn0051674,CG31674,2L,20831262,20832859,1597
FBgn0051676,CG31676,2L,20840750,20849182,8432
FBgn0032895,twit,2L,20852578,20857113,4535
FBgn0032897,bero,2L,20858695,20861014,2319
FBgn0032899,CG9338,2L,20865215,20867709,2494
FBgn0051675,CG31675,2L,20867755,20869650,1895
FBgn0032900,CG14401,2L,20869854,20871565,1711
FBgn0032908,CG9270,2L,20929456,20934113,4657
FBgn0032901,sky,2L,20871335,20918931,47596
FBgn0032891,Oseg5,2L,20832849,20835840,2991
FBgn0053322,CG33322,2L,20814337,20816240,1903
FBgn0032883,Rhau,2L,20754579,20757985,3406
FBgn0032881,Amacr,2L,20750934,20752341,1407
FBgn0010395,Itgbn,2L,21053033,21058044,5011
FBgn0032911,tadr,2L,21075405,21081053,5648
FBgn0032916,CG9257,2L,21102743,21104321,1578
FBgn0040297,Nhe2,2L,21104568,21134255,29687
FBgn0032919,pths,2L,21143229,21145146,1917
FBgn0032921,Mpp6,2L,21156288,21157685,1397
FBgn0032923,Pld3,2L,21158847,21160903,2056
FBgn0032925,Noc2,2L,21163641,21166090,2449
FBgn0010100,mAcon1,2L,21168570,21173185,4615
FBgn0051627,CG31627,2L,21173222,21174179,957
FBgn0032929,Mcm10,2L,21179933,21182812,2879
FBgn0026255,clumsy,2L,21206493,21211818,5325
FBgn0026577,CG8677,2L,21221312,21232059,10747
FBgn0021856,l(2)k14505,2L,21261168,21262411,1243
FBgn0032938,CG8671,2L,21262956,21282790,19834
FBgn0051626,CG31626,2L,21232495,21236733,4238
FBgn0032935,Atg18b,2L,21212322,21220572,8250
FBgn0032934,CG8679,2L,21216004,21218544,2540
FBgn0003930,snRNA:U4:39B,2L,21215036,21215178,142
FBgn0051988,CG31988,2L,21201493,21202802,1309
FBgn0051624,CG31624,2L,21199045,21200375,1330
FBgn0011829,Ret,2L,21182446,21198762,16316
FBgn0000239,bur,2L,21174182,21179683,5501
FBgn0032924,Nbr,2L,21160636,21163083,2447
FBgn0032922,Coq3,2L,21157433,21158611,1178
FBgn0024371,E2f2,2L,21154293,21156749,2456
FBgn0023388,Dap160,2L,21134439,21142347,7908
FBgn0032910,CG9265,2L,21057706,21071502,13796
FBgn0023091,dimm,2L,21331756,21342155,10399
FBgn0032943,Tsp39D,2L,21344607,21358271,13664
FBgn0023090,dtr,2L,21361216,21367288,6072
FBgn0032945,CG8665,2L,21371227,21377995,6768
FBgn0032946,nrv3,2L,21380000,21393319,13319
FBgn0041245,Gr39b,2L,21367908,21369706,1798
FBgn0032940,Mondo,2L,21286078,21310050,23972
FBgn0041336,Cyp6t2Psi,2L,21282811,21284273,1462
FBgn0037502,wa-cup,3R,7420765,7423057,2292
FBgn0037503,CG14598,3R,7439760,7441976,2216
FBgn0003885,alphaTub84D,3R,7530753,7532732,1979
FBgn0015570,alpha-Est2,3R,7541810,7545230,3420
FBgn0051146,Nlg1,3R,7658247,7694874,36627
FBgn0015568,alpha-Est1,3R,7545733,7549124,3391
FBgn0015571,alpha-Est3,3R,7538972,7541631,2659
FBgn0015572,alpha-Est4,3R,7536687,7538615,1928
FBgn0015831,Rtnl2,3R,7528864,7530241,1377
FBgn0015574,alpha-Est6,3R,7524567,7528777,4210
FBgn0015575,alpha-Est7,3R,7519563,7523753,4190
FBgn0017456,Ubc84D,3R,7518820,7519456,636
FBgn0015576,alpha-Est8,3R,7509343,7515670,6327
FBgn0037506,Mics1,3R,7500951,7502376,1425
FBgn0015577,alpha-Est9,3R,7493921,7505098,11177
FBgn0015569,alpha-Est10,3R,7486583,7493845,7262
FBgn0037504,CG1142,3R,7472458,7473781,1323
FBgn0043853,scaRNA:MeU5-C46,3R,7472907,7473222,315
FBgn0040670,e(y)2b,3R,7093935,7094727,792
FBgn0037472,CG10098,3R,7124548,7126503,1955
FBgn0051248,CG31248,3R,7129320,7130908,1588
FBgn0051494,tRNA:Gly-TCC-1-1,3R,7129864,7129935,71
FBgn0037475,Fer1,3R,7136206,7141972,5766
FBgn0037478,CG2656,3R,7144724,7151270,6546
FBgn0011020,Sas-4,3R,7151367,7154219,2852
FBgn0002306,sas,3R,7162808,7183702,20894
FBgn0037483,CG14609,3R,7200970,7203450,2480
FBgn0037487,thw,3R,7224414,7241138,16724
FBgn0037488,CG14607,3R,7241760,7244006,2246
FBgn0037490,CG10053,3R,7247090,7248140,1050
FBgn0037492,Dtwd2,3R,7249795,7251750,1955
FBgn0028400,Syt4,3R,7266065,7270809,4744
FBgn0004172,Mst84Da,3R,7365850,7366262,412
FBgn0004173,Mst84Db,3R,7365160,7365627,467
FBgn0004174,Mst84Dc,3R,7364254,7364673,419
FBgn0004175,Mst84Dd,3R,7363307,7363773,466
FBgn0001112,Gld,3R,7252063,7265703,13640
FBgn0011282,Obp84a,3R,7250725,7251957,1232
FBgn0037491,CG1227,3R,7248151,7249738,1587
FBgn0037489,Noc3,3R,7244232,7246969,2737
FBgn0037486,CG14605,3R,7217679,7219705,2026
FBgn0037482,CG10055,3R,7184101,7186673,2572
FBgn0037481,MAGE,3R,7154238,7155180,942
FBgn0037477,CG14610,3R,7143729,7144295,566
FBgn0037473,CG10068,3R,7126271,7128027,1756
FBgn0014863,Mlp84B,3R,7112850,7117732,4882
FBgn0000071,Ama,3R,6762593,6765261,2668
FBgn0000439,Dfd,3R,6791836,6802428,10592
FBgn0000003,7SLRNA:CR32864,3R,6822500,6822798,298
FBgn0024289,Sodh1,3R,7052335,7054541,2206
FBgn0026563,CG1979,3R,7054586,7058671,4085
FBgn0037463,djl,3R,7060767,7061919,1152
FBgn0037464,Mst84B,3R,7062175,7064370,2195
FBgn0037466,CG1965,3R,7067401,7071624,4223
FBgn0037468,CG1943,3R,7074859,7077981,3122
FBgn0037469,Dpck,3R,7082182,7083251,1069
FBgn0003884,alphaTub84B,3R,7086599,7088839,2240
FBgn0037470,Tailor,3R,7083225,7086083,2858
FBgn0010774,Ref1,3R,7077904,7080387,2483
FBgn0037467,Ufl1,3R,7071624,7074452,2828
FBgn0037465,CG1105,3R,7064186,7067136,2950
FBgn0003339,Scr,3R,6823120,6849981,26861
FBgn0037448,CG15186,3R,6478311,6495025,16714
FBgn0051286,CG31286,3R,6641232,6643346,2114
FBgn0010355,Taf1,3R,6646889,6656048,9159
FBgn0004777,Ccp84Ag,3R,6686728,6688039,1311
FBgn0004782,Ccp84Ab,3R,6701968,6702877,909
FBgn0004779,Ccp84Ae,3R,6690887,6691758,871
FBgn0024912,agt,3R,6658806,6660100,1294
FBgn0026566,CG1307,3R,6656030,6657442,1412
FBgn0026565,Ass,3R,6642262,6644434,2172
FBgn0037461,CG15177,3R,6628204,6629321,1117
FBgn0037460,sowi,3R,6626930,6627900,970
FBgn0053202,dpr11,3R,6529169,6593330,64161
FBgn0037454,CG1137,3R,6558618,6560351,1733
FBgn0037429,Osi19,3R,6335362,6337196,1834
FBgn0037433,CG17919,3R,6344029,6345087,1058
FBgn0037435,CG18048,3R,6346111,6347519,1408
FBgn0037436,Hr83,3R,6349243,6350512,1269
FBgn0037439,CG10286,3R,6368965,6371115,2150
FBgn0010282,TfIIFalpha,3R,6380467,6382604,2137
FBgn0037442,gzl,3R,6382914,6388304,5390
FBgn0037446,Zif,3R,6457088,6458822,1734
FBgn0037447,Neurochondrin,3R,6468437,6471016,2579
FBgn0037445,CG9727,3R,6449944,6456676,6732
FBgn0037443,Dmtn,3R,6389162,6405895,16733
FBgn0037440,CRAT,3R,6371026,6376044,5018
FBgn0037512,CG2616,3R,7722417,7724715,2298
FBgn0037515,Sp7,3R,7759786,7763947,4161
FBgn0037518,CG2641,3R,7794069,7796599,2530
FBgn0051472,sgll,3R,7810532,7811912,1380
FBgn0051473,CG31473,3R,7811814,7813009,1195
FBgn0037526,ArgRS-m,3R,7887045,7890150,3105
FBgn0024909,Taf7,3R,7907333,7909721,2388
FBgn0014931,kipf,3R,7913851,7916550,2699
FBgn0002542,lds,3R,7920431,7924491,4060
FBgn0000504,dsx,3R,7924323,7967408,43085
FBgn0037531,CG10445,3R,7916599,7920299,3700
FBgn0014930,Rfk,3R,7912017,7913290,1273
FBgn0004901,Prat,3R,7909598,7911779,2181
FBgn0037530,EMC1,3R,7903030,7907363,4333
FBgn0037529,mRpS9,3R,7889277,7902667,13390
FBgn0037521,CG2993,3R,7804665,7810014,5349
FBgn0037520,CG18268,3R,7802831,7804432,1601
FBgn0037519,CG3014,3R,7799264,7802793,3529
FBgn0042101,CG18744,3R,7797078,7798771,1693
FBgn0042104,CG18747,3R,7780884,7783446,2562
FBgn0037513,pyd3,3R,7747913,7750079,2166
FBgn0010401,Os-C,3R,7978959,7979614,655
FBgn0037535,PIG-H,3R,7999832,8001064,1232
FBgn0037536,CG2698,3R,8001562,8006033,4471
FBgn0037538,CG3223,3R,8009400,8011018,1618
FBgn0037540,Pbp95,3R,8013791,8016610,2819
FBgn0037543,CG10903,3R,8030411,8032145,1734
FBgn0037546,mAChR-B,3R,8059284,8087049,27765
FBgn0037547,CG7910,3R,8087252,8089526,2274
FBgn0037548,CG7900,3R,8094124,8105083,10959
FBgn0037551,Arl8,3R,8126605,8129835,3230
FBgn0037552,CG7800,3R,8217957,8219734,1777
FBgn0037553,CG18249,3R,8220146,8222188,2042
FBgn0037554,PolI,3R,8233507,8237389,3882
FBgn0040528,CG15864,3R,8248438,8250324,1886
FBgn0037556,CG9636,3R,8240747,8243792,3045
FBgn0001138,grn,3R,8147368,8181444,34076
FBgn0037544,CG11035,3R,8031130,8033009,1879
FBgn0037541,CG2747,3R,8016210,8030790,14580
FBgn0001255,ImpE3,3R,8028453,8029546,1093
FBgn0037539,CG10435,3R,8010907,8013201,2294
FBgn0040524,CG11052,3R,8008249,8009297,1048
FBgn0037537,CG2767,3R,8005924,8008110,2186
FBgn0037534,Elovl7,3R,7981817,7995852,14035
FBgn0037533,CD98hc,3R,7974409,7978428,4019
FBgn0014861,Mcm2,3R,8264970,8267924,2954
FBgn0010433,ato,3R,8278052,8279274,1222
FBgn0037562,Nazo,3R,8287876,8288613,737
FBgn0037566,mRpL1,3R,8301440,8302770,1330
FBgn0037573,CG7483,3R,8313208,8314864,1656
FBgn0062412,Ctr1B,3R,8317612,8319205,1593
FBgn0004908,Arl2,3R,8341100,8341872,772
FBgn0037580,DppIII,3R,8344400,8347465,3065
FBgn0037581,CG7352,3R,8347579,8349296,1717
FBgn0020249,stck,3R,8356978,8359964,2986
FBgn0037589,Obp85a,3R,8419822,8420597,775
FBgn0037583,Veneno,3R,8359958,8362554,2596
FBgn0037578,PNKP,3R,8341661,8343516,1855
FBgn0040529,COX7A,3R,8339944,8341043,1099
FBgn0003129,Poxm,3R,8319025,8333792,14767
FBgn0037574,Coq2,3R,8314784,8316543,1759
FBgn0037570,CG11693,3R,8308881,8310778,1897
FBgn0037569,tex,3R,8307473,8308645,1172
FBgn0037565,CG9626,3R,8293843,8300978,7135
FBgn0037561,CG9630,3R,8267943,8269896,1953
FBgn0010173,RPA1,3R,8262120,8264451,2331
FBgn0037592,CG11737,3R,8517868,8521378,3510
FBgn0051454,CG31454,3R,8521658,8523520,1862
FBgn0051259,CG31259,3R,8523944,8526667,2723
FBgn0051460,CG31460,3R,8562673,8563445,772
FBgn0037602,SLIRP2,3R,8651084,8651493,409
FBgn0037603,Sys1,3R,8652821,8653847,1026
FBgn0037606,CG8032,3R,8664115,8667772,3657
FBgn0037607,CG8036,3R,8667868,8673702,5834
FBgn0000447,Dhod,3R,8651391,8652916,1525
FBgn0024326,Mkk4,3R,8646172,8650796,4624
FBgn0037601,Cyp313b1,3R,8643070,8645650,2580
FBgn0026399,Or85e,3R,8634320,8635878,1558
FBgn0051450,mRpS18A,3R,8561917,8562593,676
FBgn0051453,pch2,3R,8559540,8561764,2224
FBgn0037591,Or85c,3R,8511734,8513022,1288
FBgn0037590,Or85b,3R,8510077,8511358,1281
FBgn0037608,mRpL19,3R,8674109,8675196,1087
FBgn0037610,CG8043,3R,8676915,8678233,1318
FBgn0037611,CG11755,3R,8676915,8678955,2040
FBgn0037612,CG8112,3R,8712933,8715263,2330
FBgn0037614,TMEM216,3R,8716243,8721320,5077
FBgn0037615,CG11760,3R,8719198,8721320,2122
FBgn0037616,CG8136,3R,8721371,8723051,1680
FBgn0037617,nom,3R,8723174,8725357,2183
FBgn0037619,CG8159,3R,8726854,8728370,1516
FBgn0037622,CG8202,3R,8732091,8735837,3746
FBgn0037624,Nasp,3R,8747798,8754104,6306
FBgn0037626,CG8236,3R,8769394,8771150,1756
FBgn0037630,Ir85a,3R,8794684,8796966,2282
FBgn0037632,CCT7,3R,8801564,8806234,4670
FBgn0037634,hng2,3R,8806322,8807581,1259
FBgn0040532,CG8369,3R,8822008,8822838,830
FBgn0037638,CG8379,3R,8824411,8827279,2868
FBgn0037637,IscU,3R,8822849,8824177,1328
FBgn0037633,CG9839,3R,8803471,8805802,2331
FBgn0053189,CG33189,3R,8780113,8780789,676
FBgn0053191,CG33191,3R,8778379,8779923,1544
FBgn0037627,CG13318,3R,8771246,8772691,1445
FBgn0037625,CG11768,3R,8749206,8768200,18994
FBgn0037623,CG9801,3R,8735879,8747675,11796
FBgn0037621,M1BP,3R,8729790,8731698,1908
FBgn0037620,ranshi,3R,8728367,8729693,1326
FBgn0037613,Cks85A,3R,8712906,8718456,5550
FBgn0001180,hb,3R,8690980,8697822,6842
FBgn0037609,Unc50,3R,8675283,8676613,1330
FBgn0037643,ScsbetaA,3R,8938724,8943027,4303
FBgn0037646,CAHbeta,3R,8980860,8982793,1933
FBgn0027503,CG11970,3R,8984718,8990649,5931
FBgn0037648,CG11975,3R,8993253,8995212,1959
FBgn0037652,CG11980,3R,9004017,9005331,1314
FBgn0037653,Iru,3R,9006456,9008030,1574
FBgn0037654,CG11983,3R,9008321,9010274,1953
FBgn0037656,CG11986,3R,9015446,9016822,1376
FBgn0037657,hyx,3R,9038760,9042349,3589
FBgn0028708,Mst85C,3R,9048645,9052231,3586
FBgn0037659,Kdm2,3R,9052495,9063245,10750
FBgn0037661,Ada,3R,9065183,9066303,1120
FBgn0037662,CG11997,3R,9177517,9179098,1581
FBgn0037664,CG8420,3R,9246649,9251431,4782
FBgn0037665,St2,3R,9251843,9253514,1671
FBgn0037667,CG16734,3R,9255052,9256731,1679
FBgn0037670,Ibf1,3R,9258964,9260400,1436
FBgn0037671,ATP6AP2,3R,9260638,9262590,1952
FBgn0010803,TrpRS,3R,9265027,9266904,1877
FBgn0037672,sage,3R,9262654,9264142,1488
FBgn0037669,Ibf2,3R,9257727,9258501,774
FBgn0037668,CG16736,3R,9256689,9257716,1027
FBgn0000412,D1,3R,9238083,9240654,2571
FBgn0003165,pum,3R,9066343,9237682,171339
FBgn0037660,beag,3R,9063132,9065078,1946
FBgn0010222,Nmdmc,3R,9042508,9050555,8047
FBgn0002932,neur,3R,9020348,9039471,19123
FBgn0040534,Sf3b5,3R,9014972,9015341,369
FBgn0037655,Kcmf1,3R,9010282,9014909,4627
FBgn0026380,Prosbeta3,3R,9005313,9006226,913
FBgn0051100,CG31100,3R,8995229,9003650,8421
FBgn0037647,RagA-B,3R,8982732,8984315,1583
FBgn0037644,CG11964,3R,8942954,8945020,2066
FBgn0037680,pasi2,3R,9335170,9337459,2289
FBgn0037683,CG18473,3R,9363305,9364838,1533
FBgn0037684,Srr,3R,9365398,9367763,2365
FBgn0037687,CG8132,3R,9401495,9402618,1123
FBgn0037689,CG8135,3R,9404385,9407857,3472
FBgn0011740,alpha-Man-IIa,3R,9412548,9417264,4716
FBgn0037697,GstZ2,3R,9456815,9460652,3837
FBgn0037696,GstZ1,3R,9455517,9456546,1029
FBgn0037690,Task7,3R,9410329,9412293,1964
FBgn0003889,betaTub85D,3R,9408383,9410282,1899
FBgn0037688,CG9356,3R,9402564,9404269,1705
FBgn0037686,RpL34b,3R,9400237,9401226,989
FBgn0000723,FER,3R,9367603,9394546,26943
FBgn0037679,Aduk,3R,9332064,9334714,2650
FBgn0037678,CG16749,3R,9330885,9331885,1000
FBgn0037676,CG8861,3R,9293642,9328511,34869
FBgn0037700,CG8149,3R,9504656,9505865,1209
FBgn0014022,Rlb1,3R,9513327,9514827,1500
FBgn0037703,Kdm3,3R,9516007,9520938,4931
FBgn0037702,CG8176,3R,9516007,9527237,11230
FBgn0037707,RnpS1,3R,9552034,9553747,1713
FBgn0037709,BckdhA,3R,9555785,9557776,1991
FBgn0027950,MBD-like,3R,9559760,9561533,1773
FBgn0037717,CG8301,3R,9581306,9586648,5342
FBgn0037718,P58IPK,3R,9586942,9589581,2639
FBgn0037720,CG8312,3R,9591309,9625073,33764
FBgn0037722,CG8319,3R,9627321,9628676,1355
FBgn0037723,SpdS,3R,9631641,9633673,2032
FBgn0012344,Dh44,3R,9638182,9650706,12524
FBgn0037727,Nepl12,3R,9675523,9677778,2255
FBgn0037728,p23,3R,9677927,9679658,1731
FBgn0028997,nmdyn-D7,3R,9679939,9681502,1563
FBgn0037731,CG18542,3R,9685760,9687141,1381
FBgn0052939,CG32939,3R,9693079,9694461,1382
FBgn0003886,alphaTub85E,3R,9731221,9733250,2029
FBgn0002431,hyd,3R,9714623,9725615,10992
FBgn0037734,trbd,3R,9705996,9711037,5041
FBgn0051352,Unc-115a,3R,9694386,9705417,11031
FBgn0053105,p24-2,3R,9687402,9692794,5392
FBgn0260463,Unc-115b,3R,9687060,9692775,5715
FBgn0069242,eca,3R,9684469,9685476,1007
FBgn0037730,CG9444,3R,9681415,9684264,2849
FBgn0003334,Scm,3R,9633359,9637611,4252
FBgn0005585,Calr,3R,9628691,9630851,2160
FBgn0037721,CG9427,3R,9625157,9626930,1773
FBgn0027338,Kap-alpha3,3R,9574484,9577733,3249
FBgn0037715,CG9399,3R,9571911,9574211,2300
FBgn0037714,CG9396,3R,9570414,9571623,1209
FBgn0037713,CG16790,3R,9569074,9570214,1140
FBgn0037710,CG9393,3R,9561583,9563673,2090
FBgn0024833,AP-1mu,3R,9557712,9559525,1813
FBgn0037708,CG9386,3R,9553696,9555408,1712
FBgn0037705,mura,3R,9535625,9551806,16181
FBgn0000244,by,3R,9528238,9533011,4773
FBgn0014023,mRpL47,3R,9514822,9515908,1086
FBgn0003205,Ras85D,3R,9510561,9513067,2506
FBgn0014380,RhoL,3R,9497101,9502581,5480
FBgn0037698,CG16779,3R,9461084,9493677,32593
FBgn0037737,Pnn,3R,9740899,9742844,1945
FBgn0051415,CG31415,3R,9743517,9744662,1145
FBgn0005777,PpD3,3R,9747875,9751094,3219
FBgn0037743,Alg12,3R,9756491,9759313,2822
FBgn0037751,topi,3R,9775121,9777943,2822
FBgn0037753,CG12947,3R,9780064,9783054,2990
FBgn0037754,CG8500,3R,9784653,9789323,4670
FBgn0037756,CG8507,3R,9791483,9793098,1615
FBgn0037757,CG8516,3R,9793295,9797754,4459
FBgn0037759,CG8526,3R,9801280,9803461,2181
FBgn0037762,eloF,3R,9814161,9815158,997
FBgn0037770,Art4,3R,9982816,9986060,3244
FBgn0037766,Teh1,3R,9826081,9868120,42039
FBgn0037765,CG9458,3R,9818914,9819877,963
FBgn0037763,CG16904,3R,9815928,9816979,1051
FBgn0037760,FBXO11,3R,9803486,9809368,5882
FBgn0037758,CG9467,3R,9797769,9801026,3257
FBgn0037755,CG12945,3R,9787816,9791221,3405
FBgn0002868,MtnA,3R,9783407,9784370,963
FBgn0037750,Whamy,3R,9771795,9774419,2624
FBgn0037749,CG9471,3R,9770532,9771542,1010
FBgn0024330,MED6,3R,9766031,9768984,2953
FBgn0037742,Rpt3R,3R,9754735,9756510,1775
FBgn0037741,Tti1,3R,9751088,9754686,3598
FBgn0037739,CG12948,3R,9746167,9747744,1577
FBgn0037736,side-VII,3R,9734012,9739979,5967
FBgn0037772,Spn85F,3R,9997163,10000314,3151
FBgn0027524,CG3909,3R,10043270,10044606,1336
FBgn0037778,mtTFB2,3R,10045574,10047260,1686
FBgn0037780,ohgt,3R,10049199,10051527,2328
FBgn0051410,Npc2e,3R,10053332,10054348,1016
FBgn0041105,nerfin-2,3R,10071117,10073761,2644
FBgn0037788,CAH7,3R,10112237,10120081,7844
FBgn0051477,ATPsynepsilonL,3R,10121773,10122320,547
FBgn0037796,CG12814,3R,10171156,10189603,18447
FBgn0040238,Best1,3R,10161464,10170487,9023
FBgn0037794,CG6254,3R,10159144,10161331,2187
FBgn0037792,TAF1B,3R,10140103,10144184,4081
FBgn0004889,tws,3R,10126129,10139772,13643
FBgn0001321,knk,3R,10122365,10125664,3299
FBgn0028734,Fmr1,3R,10101420,10110121,8701
FBgn0037781,Fancl,3R,10051508,10052869,1361
FBgn0037779,CG12811,3R,10047252,10048797,1545
FBgn0037777,CG11722,3R,10044596,10045542,946
FBgn0053208,Mical,3R,10001554,10042895,41341
FBgn0051407,CG31407,3R,10022845,10025150,2305
FBgn0037773,CG5359,3R,9999771,10001276,1505
FBgn0037797,CG12420,3R,10222698,10223745,1047
FBgn0037801,CG3999,3R,10251518,10255268,3750
FBgn0040078,pont,3R,10262123,10263899,1776
FBgn0037809,CG12818,3R,10331581,10332695,1114
FBgn0037810,sle,3R,10333115,10338265,5150
FBgn0037811,CG12592,3R,10338342,10340872,2530
FBgn0015396,jumu,3R,10350182,10361612,11430
FBgn0020379,Rfx,3R,10361760,10378068,16308
FBgn0037807,CG6293,3R,10307806,10311613,3807
FBgn0037802,Sirt6,3R,10255349,10261849,6500
FBgn0037798,CG12817,3R,10223440,10224725,1285
FBgn0025879,Timp,3R,10203875,10213007,9132
FBgn0045443,mthl11,3R,10401032,10402966,1934
FBgn0037815,Rrp46,3R,10413301,10414242,941
FBgn0037817,Cyp12e1,3R,10434789,10436704,1915
FBgn0037816,CG6345,3R,10414218,10416046,1828
FBgn0024957,Irp-1B,3R,10408618,10412869,4251
FBgn0037814,CG6325,3R,10402967,10407285,4318
FBgn0037831,Cap-H2,3R,10761310,10766756,5446
FBgn0037832,Desi,3R,10779569,10780825,1256
FBgn0017577,Mcm5,3R,10788524,10791150,2626
FBgn0037835,CG14687,3R,10792904,10793643,739
FBgn0037838,TTLL15,3R,10815288,10817490,2202
FBgn0037841,CG4565,3R,10852724,10853644,920
FBgn0037843,CG4511,3R,10854501,10856412,1911
FBgn0037844,CG4570,3R,10856807,10858066,1259
FBgn0037848,Tsp86D,3R,10868708,10870555,1847
FBgn0037849,CG4596,3R,10873038,10875582,2544
FBgn0011768,Fdh,3R,10870906,10872381,1475
FBgn0037846,CG6574,3R,10860531,10862988,2457
FBgn0037845,CG14694,3R,10858202,10859813,1611
FBgn0037842,CG6567,3R,10853374,10854451,1077
FBgn0037837,CG14693,3R,10811581,10815047,3466
FBgn0037834,Art1,3R,10786481,10788226,1745
FBgn0010421,TfIIFbeta,3R,10766622,10767804,1182
FBgn0051390,MED7,3R,10760071,10761032,961
FBgn0051272,CG31272,3R,10756296,10759398,3102
FBgn0004841,TkR86C,3R,10737592,10751228,13636
FBgn0051373,CG31373,3R,10708487,10709364,877
FBgn0051278,CG31278,3R,10707398,10708340,942
FBgn0051467,CG31467,3R,10705170,10706863,1693
FBgn0051391,CG31391,3R,10703372,10705075,1703
FBgn0037819,Phyhd1,3R,10677737,10680925,3188
FBgn0037818,CG6465,3R,10675560,10677251,1691
FBgn0037856,Leash,3R,10885540,10896418,10878
FBgn0037855,CG6621,3R,10889768,10893531,3763
FBgn0042094,Ak3,3R,10887345,10889588,2243
FBgn0037853,CG14696,3R,10882433,10885001,2568
FBgn0037852,Tpc1,3R,10879572,10882188,2616
FBgn0037850,CG14695,3R,10878204,10879319,1115
FBgn0037862,mAcon2,3R,11137177,11139742,2565
FBgn0040257,Ugt302E1,3R,11154626,11156513,1887
FBgn0040259,Ugt302C1,3R,11157098,11159744,2646
FBgn0027584,CG4757,3R,11161207,11163498,2291
FBgn0040252,Ugt303A1,3R,11175529,11177910,2381
FBgn0037874,Tctp,3R,11210247,11211898,1651
FBgn0037876,CG4820,3R,11216535,11217898,1363
FBgn0020910,RpL3,3R,11221894,11225173,3279
FBgn0037879,scpr-C,3R,11225520,11226681,1161
FBgn0037880,CG17726,3R,11226762,11228227,1465
FBgn0037883,Dph3,3R,11231912,11232539,627
FBgn0037885,CG17721,3R,11235140,11236077,937
FBgn0051441,CG31441,3R,11236286,11237624,1338
FBgn0051388,CG31388,3R,11237815,11240114,2299
FBgn0037889,scpr-A,3R,11241183,11242120,937
FBgn0037891,Dlst,3R,11244302,11246862,2560
FBgn0037890,CG17734,3R,11242208,11243999,1791
FBgn0037888,scpr-B,3R,11240041,11240991,950
FBgn0037884,Arfip,3R,11232429,11235013,2584
FBgn0037882,CG17187,3R,11230617,11231879,1262
FBgn0037881,GCC88,3R,11228158,11230600,2442
FBgn0037878,CG6693,3R,11220268,11221639,1371
FBgn0037877,CG6689,3R,11217898,11220064,2166
FBgn0037875,ZnT86D,3R,11212308,11214539,2231
FBgn0037873,SdhC,3R,11208887,11209849,962
FBgn0026315,Ugt35A1,3R,11170817,11172664,1847
FBgn0026314,Ugt35B1,3R,11168503,11170246,1743
FBgn0040255,Ugt35E2,3R,11166177,11167981,1804
FBgn0040251,Ugt302K1,3R,11151026,11153849,2823
FBgn0040256,Ugt35C1,3R,11126597,11128328,1731
FBgn0037892,mRpL40,3R,11407918,11408756,838
FBgn0011774,Irbp,3R,11410047,11412440,2393
FBgn0037894,Ipo9,3R,11412522,11416142,3620
FBgn0037897,Sptz,3R,11422092,11429969,7877
FBgn0037898,Dtd,3R,11430061,11430762,701
FBgn0037900,CG5276,3R,11431738,11433543,1805
FBgn0037902,CG5281,3R,11435850,11437523,1673
FBgn0046225,CG17230,3R,11437785,11467372,29587
FBgn0037908,dpr5,3R,11499984,11505951,5967
FBgn0037906,PGRP-LB,3R,11452849,11460552,7703
FBgn0051374,sals,3R,11437547,11451791,14244
FBgn0037901,Exd2,3R,11433488,11435703,2215
FBgn0037899,RpL24-like,3R,11430740,11431582,842
FBgn0037896,ninaG,3R,11419376,11421693,2317
FBgn0037895,bumpel,3R,11416218,11418668,2450
FBgn0026064,KP78a,3R,11346294,11353131,6837
FBgn0026063,KP78b,3R,11346294,11353131,6837
FBgn0037911,CG10898,3R,11557776,11559877,2101
FBgn0037917,wkd,3R,11581576,11585305,3729
FBgn0037920,CG14710,3R,11620090,11621728,1638
FBgn0037922,CG14711,3R,11623339,11624948,1609
FBgn0042205,CG18764,3R,11626889,11628452,1563
FBgn0037924,CG14712,3R,11628759,11633206,4447
FBgn0037926,Elp1,3R,11650971,11655691,4720
FBgn0037930,CG14715,3R,11674221,11674923,702
FBgn0037933,Ho,3R,11679743,11680976,1233
FBgn0037939,CG14718,3R,11700614,11702720,2106
FBgn0025821,I-t,3R,11704030,11704916,886
FBgn0037941,CG12594,3R,11721734,11732479,10745
FBgn0037942,CG14721,3R,11735447,11736877,1430
FBgn0037943,CG14722,3R,11741890,11744027,2137
FBgn0037944,CG6923,3R,11744229,11750029,5800
FBgn0002906,Blm,3R,11736810,11741783,4973
FBgn0037937,Fer3,3R,11693410,11694311,901
FBgn0042110,CG18765,3R,11690386,11691799,1413
FBgn0037936,CG6908,3R,11688381,11690051,1670
FBgn0037935,CG6834,3R,11684672,11688133,3461
FBgn0037934,CG6830,3R,11680972,11684342,3370
FBgn0011290,Taf12,3R,11678386,11679690,1304
FBgn0037931,CG18476,3R,11674920,11678116,3196
FBgn0037923,CG6813,3R,11625051,11626638,1587
FBgn0037921,Zaf1,3R,11621466,11625644,4178
FBgn0051363,Jupiter,3R,11590386,11619906,29520
FBgn0037918,CG6791,3R,11585354,11590146,4792
FBgn0037915,CG6790,3R,11575901,11578745,2844
FBgn0037950,HisCl1,3R,11787176,11789393,2217
FBgn0019624,COX5A,3R,11819359,11820299,940
FBgn0003312,sad,3R,11877235,11879754,2519
FBgn0051368,CG31368,3R,11882790,11892382,9592
FBgn0051211,CG31211,3R,11949680,11954038,4358
FBgn0013276,Hsp70Ab,3R,11958535,11960909,2374
FBgn0000147,aurA,3R,11963124,11964826,1702
FBgn0037970,GC2,3R,11971694,11972896,1202
FBgn0037976,Tk,3R,11994175,12005473,11298
FBgn0037974,CG12224,3R,11980704,11982062,1358
FBgn0037973,CG18547,3R,11978574,11980390,1816
FBgn0037972,CG10005,3R,11975156,11977197,2041
FBgn0013275,Hsp70Aa,3R,11954163,11956544,2381
FBgn0037963,Cad87A,3R,11893512,11949129,55617
FBgn0037962,Dnali1,3R,11892306,11893297,991
FBgn0037960,mthl5,3R,11883938,11887168,3230
FBgn0037958,CG6962,3R,11879702,11882534,2832
FBgn0037956,CG6959,3R,11822702,11869460,46758
FBgn0037955,Kyat,3R,11820381,11822493,2112
FBgn0051116,ClC-a,3R,11797244,11813207,15963
FBgn0025802,Sbf,3R,11789293,11796948,7655
FBgn0037949,prd1,3R,11781131,11787014,5883
FBgn0017581,Lk6,3R,11750931,11764457,13526
FBgn0037979,GCC185,3R,12010772,12015059,4287
FBgn0037981,Spt3,3R,12017156,12018550,1394
FBgn0037985,ssp5,3R,12033142,12035525,2383
FBgn0051361,dpr17,3R,12094876,12111420,16544
FBgn0037995,Adk1,3R,12197941,12199473,1532
FBgn0037994,eIF3d2,3R,12192703,12195011,2308
FBgn0037993,dpr15,3R,12138833,12158595,19762
FBgn0037992,CG4702,3R,12121583,12128201,6618
FBgn0037989,ATP8B,3R,12068375,12090612,22237
FBgn0037988,Cs2,3R,12061070,12062944,1874
FBgn0037987,CG14739,3R,12048253,12049213,960
FBgn0037980,DCAF12,3R,12014943,12017031,2088
FBgn0037978,KLHL18,3R,12007476,12010434,2958
FBgn0038000,Rsbp15,3R,12222387,12224048,1661
FBgn0038008,CG3942,3R,12254187,12256592,2405
FBgn0003651,svp,3R,12258737,12302785,44048
FBgn0038009,CG17738,3R,12270890,12271300,410
FBgn0038011,CG4066,3R,12311353,12313119,1766
FBgn0038017,CG4115,3R,12360008,12363255,3247
FBgn0010038,GstD2,3R,12371971,12372704,733
FBgn0010039,GstD3,3R,12373068,12373813,745
FBgn0010040,GstD4,3R,12374100,12374824,724
FBgn0010041,GstD5,3R,12375733,12376572,839
FBgn0010042,GstD6,3R,12377128,12377907,779
FBgn0010044,GstD8,3R,12380008,12380815,807
FBgn0038029,GstD11,3R,12383336,12385624,2288
FBgn0053098,CG33098,3R,12387188,12388794,1606
FBgn0038038,CG5167,3R,12406532,12408107,1575
FBgn0038039,CG5196,3R,12408316,12411768,3452
FBgn0082831,pps,3R,12413828,12421251,7423
FBgn0038043,CG17202,3R,12422768,12423606,838
FBgn0038045,NANS,3R,12426578,12427877,1299
FBgn0038047,CG5245,3R,12429560,12431235,1675
FBgn0038049,Srlp,3R,12434098,12435643,1545
FBgn0043043,Desat2,3R,12436248,12437857,1609
FBgn0029512,Aos1,3R,12432533,12433822,1289
FBgn0038046,CG5641,3R,12427795,12429282,1487
FBgn0004103,Pp1-87B,3R,12423621,12425917,2296
FBgn0038042,Scgbeta,3R,12421236,12422429,1193
FBgn0000455,Dip-C,3R,12411809,12413759,1950
FBgn0038037,Cyp9f2,3R,12403340,12406028,2688
FBgn0038034,Cyp9f3,3R,12396007,12398929,2922
FBgn0038028,CG10035,3R,12380869,12382691,1822
FBgn0038020,GstD9,3R,12366163,12367564,1401
FBgn0042206,GstD10,3R,12364776,12365735,959
FBgn0038016,MBD-R2,3R,12352143,12356265,4122
FBgn0038014,CG10041,3R,12350815,12352103,1288
FBgn0038013,CG10038,3R,12348987,12350644,1657
FBgn0038007,Cyp313a3,3R,12237138,12239266,2128
FBgn0011270,Pglym87,3R,12231645,12232729,1084
FBgn0037999,CG4860,3R,12219881,12221464,1583
FBgn0037998,Cog1,3R,12213792,12219686,5894
FBgn0038053,CG18549,3R,12449296,12456355,7059
FBgn0038054,CG5509,3R,12452464,12453196,732
FBgn0038055,trus,3R,12456573,12458444,1871
FBgn0038057,Polr3C,3R,12460414,12462418,2004
FBgn0051354,Hsp70Bbb,3R,12502510,12504856,2346
FBgn0013278,Hsp70Bb,3R,12505793,12508139,2346
FBgn0013279,Hsp70Bc,3R,12509076,12511461,2385
FBgn0028374,Hug,3R,12526188,12529076,2888
FBgn0038065,Snx3,3R,12628031,12630495,2464
FBgn0260444,Not10,3R,12630647,12633188,2541
FBgn0042207,CG18530,3R,12633359,12634670,1311
FBgn0038071,Dtg,3R,12648058,12652910,4852
FBgn0038072,CG6225,3R,12654577,12660860,6283
FBgn0038073,CG14395,3R,12662831,12673959,11128
FBgn0038074,Gnmt,3R,12674608,12676084,1476
FBgn0011745,Arp1,3R,12691743,12694232,2489
FBgn0038079,NijC,3R,12695129,12697379,2250
FBgn0016693,Past1,3R,12697322,12704875,7553
FBgn0038080,CG12279,3R,12705094,12705818,724
FBgn0038082,Ugt37A2,3R,12739642,12741417,1775
FBgn0038084,beat-Vc,3R,12746036,12783216,37180
FBgn0038083,Ugt37A3,3R,12741958,12743680,1722
FBgn0002719,Men,3R,12713103,12722442,9339
FBgn0002905,PolQ,3R,12705523,12712299,6776
FBgn0051347,CG31347,3R,12691733,12692597,864
FBgn0005355,Su(fu),3R,12689873,12691468,1595
FBgn0001296,kar,3R,12682186,12689367,7181
FBgn0038076,Cyp313a4,3R,12679279,12681375,2096
FBgn0026207,mbo,3R,12676487,12679052,2565
FBgn0038070,CG6753,3R,12640163,12642482,2319
FBgn0005671,Vha55,3R,12623762,12627829,4067
FBgn0052865,lncRNA:alphagamma-element:CR32865,3R,12475336,12478267,2931
FBgn0013277,Hsp70Ba,3R,12465453,12467776,2323
FBgn0038058,CG5608,3R,12462562,12465298,2736
FBgn0038056,CG5961,3R,12458421,12460294,1873
FBgn0038051,CG17207,3R,12437817,12439139,1322
FBgn0038092,beat-Vb,3R,12916056,12934813,18757
FBgn0038088,CG10126,3R,12855544,12859246,3702
FBgn0051345,CG31345,3R,12811145,12817029,5884
FBgn0038095,Cyp304a1,3R,12963791,12965923,2132
FBgn0038099,CG7091,3R,12978000,12980535,2535
FBgn0038100,Paip2,3R,12980792,12985488,4696
FBgn0051342,CG31342,3R,12986041,12991543,5502
FBgn0038106,CG7488,3R,12995620,12996925,1305
FBgn0038108,CG7518,3R,12998089,13008404,10315
FBgn0038109,CG11656,3R,13009895,13011086,1191
FBgn0002354,l(3)87Df,3R,13030913,13031598,685
FBgn0003308,ry,3R,13032528,13038020,5492
FBgn0038113,CG11668,3R,13038375,13040184,1809
FBgn0001217,Hsc70-2,3R,13044759,13047388,2629
FBgn0004666,sim,3R,13057755,13078124,20369
FBgn0038118,timeout,3R,13088651,13163876,75225
FBgn0038115,CG7966,3R,13049398,13051453,2055
FBgn0038110,CG8031,3R,13008384,13011310,2926
FBgn0038107,CG17327,3R,12996876,12997726,850
FBgn0038105,yellow-f2,3R,12993395,12995147,1752
FBgn0041710,yellow-f,3R,12991449,12993201,1752
FBgn0038102,CG14383,3R,12987376,12988511,1135
FBgn0038098,CG7381,3R,12967775,12977471,9696
FBgn0040493,grsm,3R,12950042,12967712,17670
FBgn0040551,CG11686,3R,13260356,13262227,1871
FBgn0003598,Su(var)3-7,3R,13264364,13270038,5674
FBgn0038130,CG8630,3R,13279721,13284527,4806
FBgn0038133,Osi22,3R,13290629,13291846,1217
FBgn0052473,CG32473,3R,13302648,13312785,10137
FBgn0038140,PK2-R1,3R,13338330,13345106,6776
FBgn0027610,Dic1,3R,13364938,13369278,4340
FBgn0038142,CheA87a,3R,13369648,13370346,698
FBgn0038144,CG8870,3R,13379842,13381509,1667
FBgn0038145,Droj2,3R,13382106,13385283,3177
FBgn0038148,CG14377,3R,13397835,13398583,748
FBgn0041711,yellow-e,3R,13409543,13415286,5743
FBgn0038151,yellow-e2,3R,13405109,13406998,1889
FBgn0038149,GILT1,3R,13398526,13401862,3336
FBgn0040553,CG14374,3R,13396694,13397140,446
FBgn0038147,CCHa2,3R,13389059,13395197,6138
FBgn0038146,CG9799,3R,13385648,13388709,3061
FBgn0044511,mRpS21,3R,13381276,13381809,533
FBgn0038143,CG9813,3R,13373104,13379775,6671
FBgn0023495,Lip3,3R,13370240,13371904,1664
FBgn0038132,apn,3R,13287655,13288813,1158
FBgn0038129,TBC1D5,3R,13269137,13272011,2874
FBgn0038128,Ravus,3R,13262733,13264061,1328
FBgn0000024,Ace,3R,13222951,13259517,36566
FBgn0038127,CG8476,3R,13219644,13220578,934
FBgn0038126,CG8483,3R,13208754,13214465,5711
FBgn0000046,Act87E,3R,13425983,13428375,2392
FBgn0040554,asRNA:CR17025,3R,13455511,13466106,10595
FBgn0004049,yrt,3R,13428867,13434984,6117
FBgn0038163,CG10841,3R,13631942,13634861,2919
FBgn0015778,rin,3R,13647004,13654527,7523
FBgn0038167,Lkb1,3R,13676549,13679430,2881
FBgn0024555,flfl,3R,13683921,13693905,9984
FBgn0038170,CG14367,3R,13694053,13695513,1460
FBgn0002937,ninaB,3R,13700565,13703164,2599
FBgn0038173,Adgf-C,3R,13706757,13709129,2372
FBgn0038179,CG9312,3R,13765756,13767103,1347
FBgn0038180,Cht5,3R,13767549,13770732,3183
FBgn0038181,CG9297,3R,13771495,13779317,7822
FBgn0260464,CG9288,3R,13779624,13780795,1171
FBgn0038183,CG9286,3R,13780964,13782082,1118
FBgn0000454,Dip-B,3R,13782288,13785676,3388
FBgn0038172,Adgf-D,3R,13703084,13705402,2318
FBgn0028487,f-cup,3R,13695263,13700838,5575
FBgn0038168,omd,3R,13679440,13687210,7770
FBgn0038166,CG9588,3R,13675092,13676681,1589
FBgn0038165,Task6,3R,13667046,13674542,7496
FBgn0004237,Hrb87F,3R,13656846,13660531,3685
FBgn0010258,Rbp4,3R,13654556,13656394,1838
FBgn0003060,CG9757,3R,13611583,13612433,850
FBgn0038160,CG9759,3R,13607078,13609246,2168
FBgn0000576,ems,3R,13901853,13904620,2767
FBgn0016672,Ipp,3R,13958789,13960474,1685
FBgn0015270,Orc2,3R,13964885,13967075,2190
FBgn0038195,CG3061,3R,14032371,14035041,2670
FBgn0038196,CG9922,3R,14035018,14036398,1380
FBgn0008646,E5,3R,13867345,13874916,7571
FBgn0051495,CG31495,3R,13838240,13839934,1694
FBgn0002862,Mst87F,3R,13827151,13828008,857
FBgn0038197,foxo,3R,14056945,14087978,31033
FBgn0038198,Npc2b,3R,14089517,14092425,2908
FBgn0038203,Or88a,3R,14109445,14110823,1378
FBgn0038206,twf,3R,14122654,14124474,1820
FBgn0027083,MetRS-m,3R,14249043,14259991,10948
FBgn0038214,CG9616,3R,14244804,14245471,667
FBgn0038213,CG9624,3R,14228018,14229145,1127
FBgn0027563,CG9631,3R,14225098,14226762,1664
FBgn0053329,Sp212,3R,14222074,14224155,2081
FBgn0053109,CG33109,3R,14220560,14221584,1024
FBgn0051326,CG31326,3R,14218136,14220205,2069
FBgn0038211,CG9649,3R,14215459,14217882,2423
FBgn0011582,Dop1R1,3R,14165379,14214810,49431
FBgn0051327,CG31327,3R,14157560,14160278,2718
FBgn0051533,CG31533,3R,14154728,14157431,2703
FBgn0038208,CG14355,3R,14148508,14151940,3432
FBgn0038207,CG14356,3R,14130680,14132072,1392
FBgn0010340,140up,3R,14124163,14125548,1385
FBgn0020510,Abi,3R,14119262,14122420,3158
FBgn0038205,Kif19A,3R,14112451,14118450,5999
FBgn0038202,CG12402,3R,14104488,14108321,3833
FBgn0038200,CG9920,3R,14097293,14098080,787
FBgn0038199,CCHa1,3R,14092504,14096835,4331
FBgn0038221,IFT54,3R,14302428,14304458,2030
FBgn0004855,Polr2I,3R,14309089,14310178,1089
FBgn0051321,CG31321,3R,14310362,14314412,4050
FBgn0013767,Crz,3R,14314854,14315716,862
FBgn0011474,Set8,3R,14316038,14320494,4456
FBgn0038224,ATPsynE,3R,14326947,14327735,788
FBgn0003480,spn-B,3R,14328051,14329608,1557
FBgn0038225,soti,3R,14380663,14381699,1036
FBgn0024321,NK7.1,3R,14329413,14372951,43538
FBgn0038223,Afti,3R,14320191,14326689,6498
FBgn0003567,su(Hw),3R,14304455,14308589,4134
FBgn0038234,mRpL11,3R,14511838,14512691,853
FBgn0038236,Cyp313a1,3R,14521049,14523064,2015
FBgn0020299,stumps,3R,14577217,14608079,30862
FBgn0038246,CG14853,3R,14609642,14618987,9345
FBgn0013981,His4r,3R,14625755,14626614,859
FBgn0038247,Cad88C,3R,14630478,14641776,11298
FBgn0038250,CG3505,3R,14657447,14659228,1781
FBgn0038251,Hexim,3R,14659438,14661177,1739
FBgn0038252,BigH1,3R,14663450,14664822,1372
FBgn0025808,Rad17,3R,14661176,14663197,2021
FBgn0038248,CG7886,3R,14626676,14642563,15887
FBgn0003169,put,3R,14619030,14625703,6673
FBgn0038244,CG7987,3R,14570472,14575887,5415
FBgn0004629,Cys,3R,14569103,14569644,541
FBgn0038243,CG8066,3R,14567611,14568847,1236
FBgn0051313,CG31313,3R,14566432,14567429,997
FBgn0038238,CG14854,3R,14559166,14560054,888
FBgn0038237,Pde6,3R,14513901,14558304,44403
FBgn0038235,CG8461,3R,14512639,14513637,998
FBgn0038233,HtrA2,3R,14509049,14511712,2663
FBgn0038260,CG14855,3R,14796305,14798474,2169
FBgn0038261,CG14856,3R,14798986,14801163,2177
FBgn0038262,CG14857,3R,14801773,14804342,2569
FBgn0038266,CG3610,3R,14845043,14846737,1694
FBgn0038268,CG3631,3R,14879457,14882631,3174
FBgn0067628,CG33331,3R,14886456,14887739,1283
FBgn0067629,CG33332,3R,14886456,14889146,2690
FBgn0038271,UQCR-C1,3R,14890231,14892387,2156
FBgn0038273,CG14860,3R,14894784,14896446,1662
FBgn0038275,CG3817,3R,14898739,14899617,878
FBgn0038279,Sdr,3R,14918628,14923083,4455
FBgn0028662,VhaPPA1-1,3R,14902330,14904061,1731
FBgn0038277,RpS5b,3R,14900432,14901563,1131
FBgn0038274,Nup93-2,3R,14895703,14898372,2669
FBgn0038272,Dph2,3R,14892392,14893954,1562
FBgn0004597,CycC,3R,14889004,14890205,1201
FBgn0038269,Rrp6,3R,14882498,14886246,3748
FBgn0038257,smp-30,3R,14745901,14751246,5345
FBgn0011217,eff,3R,14732414,14741319,8905
FBgn0038256,CG7530,3R,14724760,14731509,6749
FBgn0038291,CG3984,3R,15137148,15139007,1859
FBgn0038292,CG3987,3R,15139958,15141715,1757
FBgn0038296,Kpc1,3R,15191058,15196210,5152
FBgn0038294,Mf,3R,15170625,15181510,10885
FBgn0038290,CG6912,3R,15135138,15137004,1866
FBgn0038286,CG6966,3R,15079320,15095631,16311
FBgn0038300,Mau2,3R,15209204,15211347,2143
FBgn0038302,CG4210,3R,15213974,15214845,871
FBgn0038304,CG12241,3R,15219256,15222371,3115
FBgn0038307,mRpS10,3R,15229665,15230516,851
FBgn0014879,Set,3R,15263552,15265253,1701
FBgn0016691,ATPsynO,3R,15265591,15266690,1099
FBgn0038312,Zip88E,3R,15268662,15270532,1870
FBgn0038313,CG4338,3R,15275522,15276474,952
FBgn0004117,Tm2,3R,15310193,15315197,5004
FBgn0038315,CG14866,3R,15316471,15318285,1814
FBgn0026441,ear,3R,15320756,15325279,4523
FBgn0000533,ea,3R,15328729,15330408,1679
FBgn0038319,mRpL9,3R,15330738,15331588,850
FBgn0038320,Cyfip,3R,15333266,15338365,5099
FBgn0021750,SerRS-m,3R,15340667,15343218,2551
FBgn0051301,CG31301,3R,15346205,15348012,1807
FBgn0038324,Tmtc4,3R,15351225,15353926,2701
FBgn0038326,Hibch,3R,15357229,15359263,2034
FBgn0038327,Trax,3R,15361692,15362850,1158
FBgn0038331,Ccm3,3R,15371957,15374237,2280
FBgn0041188,Atx2,3R,15408423,15417277,8854
FBgn0038339,CG6118,3R,15421108,15434738,13630
FBgn0038337,CG6125,3R,15402598,15407070,4472
FBgn0038334,h-cup,3R,15381407,15382951,1544
FBgn0038332,CG6136,3R,15370036,15372212,2176
FBgn0038330,CG14868,3R,15367816,15369945,2129
FBgn0026737,CG6171,3R,15362796,15363857,1061
FBgn0026634,Cog2,3R,15358481,15361657,3176
FBgn0038325,Atg4b,3R,15353720,15356924,3204
FBgn0019925,Surf4,3R,15343653,15346176,2523
FBgn0038321,Nagk,3R,15337908,15343256,5348
FBgn0013269,Fkbp39,3R,15331584,15333133,1549
FBgn0038318,CG6236,3R,15325325,15328269,2944
FBgn0038316,CG6276,3R,15318203,15320069,1866
FBgn0011476,l(3)neo43,3R,15277981,15278668,687
FBgn0027378,MRG15,3R,15276440,15278109,1669
FBgn0000283,Cp190,3R,15270432,15275241,4809
FBgn0038311,CG14864,3R,15266684,15268538,1854
FBgn0038309,Amt,3R,15247163,15249137,1974
FBgn0045035,tefu,3R,15232212,15242236,10024
FBgn0038306,Art3,3R,15227605,15229408,1803
FBgn0051344,CG31344,3R,15223378,15225329,1951
FBgn0051155,Polr2G,3R,15222251,15223180,929
FBgn0038303,SIDL,3R,15214762,15218874,4112
FBgn0038301,CG6654,3R,15211277,15213658,2381
FBgn0038299,Spn88Eb,3R,15206703,15208762,2059
FBgn0028984,Spn88Ea,3R,15203069,15206447,3378
FBgn0000047,Act88F,3R,15439969,15442177,2208
FBgn0038342,B9d1,3R,15481906,15482904,998
FBgn0019940,Rh6,3R,15483158,15484699,1541
FBgn0038344,obe,3R,15486050,15493310,7260
FBgn0038350,AOX4,3R,15548628,15552833,4205
FBgn0038349,AOX3,3R,15542748,15548188,5440
FBgn0038348,AOX2,3R,15537713,15542414,4701
FBgn0051296,CG31296,3R,15530072,15531473,1401
FBgn0038343,Trissin,3R,15484730,15485396,666
FBgn0053207,pxb,3R,15666183,15690513,24330
FBgn0038353,CG5399,3R,15695241,15697142,1901
FBgn0038354,CG5404,3R,15704676,15708434,3758
FBgn0038358,Ttc26,3R,15774416,15777640,3224
FBgn0038359,CG5614,3R,15779805,15781092,1287
FBgn0038360,CG9590,3R,15786703,15788339,1636
FBgn0038361,Uros2,3R,15788521,15789494,973
FBgn0038363,Acyp2,3R,15792688,15793487,799
FBgn0038365,CG9593,3R,15802275,15803653,1378
FBgn0026616,alpha-Man-IIb,3R,15804248,15824118,19870
FBgn0038366,CG4576,3R,15825747,15830321,4574
FBgn0038369,Arpc3A,3R,15834648,15836021,1373
FBgn0003483,spn-E,3R,15837419,15844415,6996
FBgn0038373,CG4546,3R,15846534,15848436,1902
FBgn0051183,CG31183,3R,15857871,15875939,18068
FBgn0038376,Hmt-1,3R,15853868,15857470,3602
FBgn0038371,Pbp45,3R,15838146,15839515,1369
FBgn0017567,ND-23,3R,15836048,15837117,1069
FBgn0003227,rec,3R,15823019,15832632,9613
FBgn0000246,c(3)G,3R,15789473,15792579,3106
FBgn0051292,CR31292,3R,15906240,15906750,510
FBgn0038381,EndoU,3R,15908398,15910367,1969
FBgn0038385,Fbxl7,3R,15920898,15932887,11989
FBgn0038387,blp,3R,15933847,15934940,1093
FBgn0013334,Sap47,3R,15935100,15962124,27024
FBgn0038389,CG5516,3R,15963884,15964761,877
FBgn0038390,Rbf2,3R,15965446,15968138,2692
FBgn0022787,Hel89B,3R,15973298,15983451,10153
FBgn0003117,pnr,3R,16026079,16041796,15717
FBgn0038396,CG5013,3R,16049670,16050693,1023
FBgn0027948,msps,3R,16050801,16060675,9874
FBgn0038398,sxe2,3R,16083878,16087222,3344
FBgn0010379,Akt,3R,16099228,16105670,6442
FBgn0052855,CG32855,3R,16078980,16080992,2012
FBgn0038397,CG10185,3R,16060589,16067594,7005
FBgn0024222,IKKbeta,3R,16046347,16049421,3074
FBgn0038395,Jhbp5,3R,16044747,16046130,1383
FBgn0002783,mor,3R,15968134,15972913,4779
FBgn0052856,CG32856,3R,15964678,15965351,673
FBgn0038388,CG4287,3R,15962167,15963867,1700
FBgn0027657,glob1,3R,15896926,15904643,7717
FBgn0038380,CG14877,3R,15889194,15896078,6884
FBgn0003319,Sb,3R,16116161,16145284,29123
FBgn0038401,CG5916,3R,16147029,16149636,2607
FBgn0063649,CG6006,3R,16154982,16171766,16784
FBgn0038404,CG8925,3R,16171991,16180475,8484
FBgn0051287,CG31287,3R,16203371,16204961,1590
FBgn0040071,tara,3R,16225651,16260329,34678
FBgn0020407,asun,3R,16264271,16266891,2620
FBgn0020399,Mst89B,3R,16267012,16268433,1421
FBgn0038412,Zip89B,3R,16305758,16308700,2942
FBgn0040271,Sulf1,3R,16310542,16339575,29033
FBgn0038407,CG6126,3R,16198000,16203083,5083
FBgn0024491,Bin1,3R,16186156,16189564,3408
FBgn0038402,Fer2,3R,16149369,16151312,1943
FBgn0038400,Mic26-27,3R,16144401,16146855,2454
FBgn0038418,pad,3R,16342318,16345829,3511
FBgn0027095,Manf,3R,16349404,16350801,1397
FBgn0051279,CG31279,3R,16430681,16432897,2216
FBgn0038424,Fntb,3R,16432998,16434740,1742
FBgn0038425,CG14881,3R,16434899,16436066,1167
FBgn0038429,CG14882,3R,16443207,16445010,1803
FBgn0038431,CG10405,3R,16454492,16455797,1305
FBgn0038432,CG14883,3R,16456052,16458233,2181
FBgn0027053,CSN5,3R,16470099,16471406,1307
FBgn0038435,Gyc89Da,3R,16472601,16475477,2876
FBgn0038436,Gyc89Db,3R,16477110,16481070,3960
FBgn0038445,CG14891,3R,16571515,16573158,1643
FBgn0038446,CG14903,3R,16573179,16573752,573
FBgn0038439,Cad89D,3R,16484566,16495422,10856
FBgn0038438,Der-2,3R,16482694,16484223,1529
FBgn0038437,Sdhaf3,3R,16481861,16482452,591
FBgn0044826,Pak3,3R,16445007,16453821,8814
FBgn0038428,Ttc1,3R,16441843,16443007,1164
FBgn0038426,mRpS33,3R,16436045,16436597,552
FBgn0003513,ss,3R,16374434,16403690,29256
FBgn0038422,js,3R,16360329,16368306,7977
FBgn0038421,CG17931,3R,16357535,16359466,1931
FBgn0038420,CG10311,3R,16350786,16357015,6229
FBgn0038419,CG14879,3R,16345825,16349226,3401
FBgn0038447,CG14892,3R,16594414,16597241,2827
FBgn0027109,NPF,3R,16609220,16611325,2105
FBgn0038449,CG17562,3R,16615309,16617154,1845
FBgn0038450,CG17560,3R,16617950,16619878,1928
FBgn0015520,nonA-l,3R,16640205,16643112,2907
FBgn0038453,Arl6IP1,3R,16643605,16645171,1566
FBgn0015019,CCT3,3R,16647605,16649978,2373
FBgn0003944,Ubx,3R,16656623,16734426,77803
FBgn0051217,modSP,3R,16652446,16655662,3216
FBgn0038455,CG14907,3R,16651217,16652319,1102
FBgn0015351,Mettl4,3R,16649981,16651157,1176
FBgn0038454,CG10324,3R,16645072,16647004,1932
FBgn0038452,Ccdc114,3R,16622735,16624717,1982
FBgn0022344,CG10340,3R,16613398,16614391,993
FBgn0027562,CG10345,3R,16597073,16604861,7788
FBgn0020907,Scp2,3R,16574543,16583663,9120
FBgn0043069,MESK4,3R,16988814,16990419,1605
FBgn0038463,CG3534,3R,16996446,16999449,3003
FBgn0038465,Irc,3R,17002875,17007208,4333
FBgn0038466,CG8907,3R,17008269,17012533,4264
FBgn0038467,Adsl,3R,17018780,17021120,2340
FBgn0038462,EMC2A,3R,16994542,16996071,1529
FBgn0038461,EMC2B,3R,16990334,16991878,1544
FBgn0038460,CG18622,3R,16983510,16987732,4222
FBgn0015011,AhcyL2,3R,16978439,16982158,3719
FBgn0015008,Actn3,3R,16975885,16977795,1910
FBgn0000015,Abd-B,3R,16927212,16972236,45024
FBgn0051268,CG31268,3R,17031802,17033515,1713
FBgn0038471,Trm7-32,3R,17040682,17041895,1213
FBgn0038476,kuk,3R,17080244,17084781,4537
FBgn0038478,cal1,3R,17088280,17091938,3658
FBgn0038484,CG5246,3R,17136111,17137195,1084
FBgn0038490,Smug,3R,17150587,17151630,1043
FBgn0038491,CG5292,3R,17151861,17153771,1910
FBgn0038494,beat-IIb,3R,17232253,17265049,32796
FBgn0051262,CG31262,3R,17217116,17223074,5958
FBgn0038492,Mur89F,3R,17152995,17202130,49135
FBgn0038488,m-cup,3R,17144475,17149412,4937
FBgn0038487,TwdlW,3R,17141208,17142404,1196
FBgn0038475,Keap1,3R,17073942,17079945,6003
FBgn0038473,Ns1,3R,17070523,17072675,2152
FBgn0038472,bdwf,3R,17041896,17043136,1240
FBgn0038470,CG18213,3R,17036394,17040203,3809
FBgn0028992,sds22,3R,17391594,17393020,1426
FBgn0038507,CG5863,3R,17411108,17412680,1572
FBgn0038511,cysu,3R,17425768,17446499,20731
FBgn0000564,Eh,3R,17446642,17448858,2216
FBgn0038510,CG14331,3R,17438968,17440728,1760
FBgn0038504,Sur-8,3R,17395199,17402515,7316
FBgn0038499,Brf,3R,17374833,17391337,16504
FBgn0038498,beat-IIa,3R,17320004,17366119,46115
FBgn0038516,P5cr-2,3R,17534815,17537136,2321
FBgn0025571,SF1,3R,17540421,17545148,4727
FBgn0038524,sll,3R,17606106,17608541,2435
FBgn0038525,CG14329,3R,17609359,17610533,1174
FBgn0038526,CG14327,3R,17613709,17614933,1224
FBgn0038530,AttD,3R,17625268,17626086,818
FBgn0038532,CG14322,3R,17647679,17669985,22306
FBgn0051576,tRNA:Ala-AGC-2-10,3R,17668187,17668259,72
FBgn0000063,Mps1,3R,17671271,17673828,2557
FBgn0038536,CG7655,3R,17682669,17683773,1104
FBgn0051360,CG31360,3R,17685097,17685807,710
FBgn0051249,CG31249,3R,17685689,17687071,1382
FBgn0051251,CG31251,3R,17683740,17684915,1175
FBgn0038533,CG7523,3R,17669144,17670895,1751
FBgn0004554,Edg91,3R,17610856,17611511,655
FBgn0038519,Prx3,3R,17545222,17546531,1309
FBgn0010926,l(3)07882,3R,17535533,17539963,4430
FBgn0038515,CG5823,3R,17532325,17534587,2262
FBgn0016650,Lgr1,3R,17725777,17733207,7430
FBgn0038540,CG14321,3R,17733598,17734381,783
FBgn0038541,TyrRII,3R,17736611,17747470,10859
FBgn0038545,pasi1,3R,17795075,17796317,1242
FBgn0038552,Alg1,3R,17809401,17811134,1733
FBgn0038551,Odj,3R,17807407,17809222,1815
FBgn0038550,CG17801,3R,17805679,17807085,1406
FBgn0038549,Nnk,3R,17803225,17805249,2024
FBgn0038548,CG17806,3R,17801542,17803260,1718
FBgn0038546,CG7379,3R,17796376,17798304,1928
FBgn0038542,TyrR,3R,17750129,17763188,13059
FBgn0038539,Atg8b,3R,17724410,17725063,653
FBgn0000477,DNaseII,3R,18019375,18021161,1786
FBgn0038564,CG7785,3R,18021600,18023689,2089
FBgn0038565,CG7794,3R,18023707,18025378,1671
FBgn0003499,sr,3R,18090803,18135583,44780
FBgn0010389,htl,3R,18045216,18052984,7768
FBgn0022943,Cbp20,3R,18164661,18165439,778
FBgn0042693,wrd,3R,18167757,18180049,12292
FBgn0038576,Arp5,3R,18185498,18187875,2377
FBgn0038578,MED17,3R,18189072,18191265,2193
FBgn0028499,CG7985,3R,18199857,18215001,15144
FBgn0038581,CG14314,3R,18216142,18218014,1872
FBgn0038582,CG7988,3R,18220526,18221473,947
FBgn0038585,Non3,3R,18223722,18224942,1220
FBgn0011701,repo,3R,18236192,18239602,3410
FBgn0020238,14-3-3epsilon,3R,18242531,18250550,8019
FBgn0038589,CG18598,3R,18251115,18251539,424
FBgn0038592,CG18599,3R,18267789,18271172,3383
FBgn0026250,eIF1A,3R,18274665,18283005,8340
FBgn0038597,CG8064,3R,18283660,18286624,2964
FBgn0024432,Dlc90F,3R,18299229,18300044,815
FBgn0038607,hmw,3R,18361994,18364277,2283
FBgn0038609,Nup43,3R,18366638,18367913,1275
FBgn0040569,lncRNA:CR14310,3R,18372928,18373329,401
FBgn0038610,CG7675,3R,18378124,18381178,3054
FBgn0038608,WRNexo,3R,18364244,18366162,1918
FBgn0038606,CG15803,3R,18330932,18360728,29796
FBgn0038603,PKD,3R,18303279,18314407,11128
FBgn0038601,Polr1E,3R,18300195,18301728,1533
FBgn0010877,l(3)05822,3R,18288866,18298879,10013
FBgn0038598,CG7131,3R,18286620,18288777,2157
FBgn0038596,CG14312,3R,18282978,18283528,550
FBgn0038595,CG7142,3R,18278181,18279522,1341
FBgn0038593,Vps39,3R,18271189,18274446,3257
FBgn0038590,CG12320,3R,18251069,18252734,1665
FBgn0038588,CG7156,3R,18239420,18242159,2739
FBgn0038586,CG7168,3R,18224902,18226082,1180
FBgn0038584,mTerf5,3R,18221522,18223682,2160
FBgn0038583,CG7183,3R,18218147,18220699,2552
FBgn0011481,Ssdp,3R,18192494,18199595,7101
FBgn0038579,CG14313,3R,18191244,18191967,723
FBgn0038577,CG12321,3R,18187805,18188707,902
FBgn0038569,CG7218,3R,18161392,18164397,3005
FBgn0038612,cona,3R,18385828,18386887,1059
FBgn0038619,CG7685,3R,18404940,18406002,1062
FBgn0038627,CG7694,3R,18573091,18590726,17635
FBgn0038630,Tssk,3R,18598691,18600097,1406
FBgn0023083,fray,3R,18573091,18589459,16368
FBgn0038629,CG14304,3R,18592801,18621327,28526
FBgn0004652,fru,3R,18414273,18545586,131313
FBgn0051122,CG31122,3R,18406064,18412874,6810
FBgn0038621,CG10864,3R,18410080,18411631,1551
FBgn0038617,Wdr37,3R,18400373,18402716,2343
FBgn0028670,Vha100-2,3R,18390323,18399169,8846
FBgn0044871,Gos28,3R,18663738,18665307,1569
FBgn0051231,CG31231,3R,18665361,18667733,2372
FBgn0051229,CG31229,3R,18667852,18669083,1231
FBgn0038638,CG7702,3R,18669390,18674679,5289
FBgn0038640,CG7706,3R,18677818,18680321,2503
FBgn0038641,ChT,3R,18680604,18686739,6135
FBgn0051226,CG31226,3R,18851305,18851798,493
FBgn0038653,Octalpha2R,3R,18799280,18849224,49944
FBgn0038652,CG7720,3R,18759236,18795169,35933
FBgn0038649,PGS1,3R,18744063,18746041,1978
FBgn0024329,Mekk1,3R,18733106,18743594,10488
FBgn0038642,Muc91C,3R,18687556,18692719,5163
FBgn0038632,CG14301,3R,18629151,18641457,12306
FBgn0051228,tRNA:Pro-TGG-1-5,3R,18628467,18628538,71
FBgn0038631,CG7695,3R,18616754,18617511,757
FBgn0038654,CG14298,3R,18875528,18877204,1676
FBgn0038655,CG14297,3R,18898121,18899342,1221
FBgn0003248,Rh2,3R,18899423,18901019,1596
FBgn0038659,EndoA,3R,18906609,18910755,4146
FBgn0022338,dnk,3R,18980995,18982749,1754
FBgn0038673,CG14286,3R,19024092,19024853,761
FBgn0038674,CG14285,3R,19025099,19026203,1104
FBgn0027785,NP15.6,3R,19027368,19028015,647
FBgn0015781,P5cr,3R,19028931,19030159,1228
FBgn0038675,CG6013,3R,19031503,19032409,906
FBgn0038676,CG6026,3R,19033538,19044693,11155
FBgn0004876,cdi,3R,19044882,19094270,49388
FBgn0027784,Prp18,3R,19029968,19031271,1303
FBgn0038672,CG6005,3R,19022458,19024030,1572
FBgn0038666,Smu1,3R,18978980,18981324,2344
FBgn0038665,euc,3R,18978273,18978809,536
FBgn0038662,Mpc1,3R,18926996,18928659,1663
FBgn0038660,Sgsh,3R,18911053,18912922,1869
FBgn0038658,CG14292,3R,18904933,18905655,722
FBgn0016120,ATPsynD,3R,19095000,19096271,1271
FBgn0038679,CG6040,3R,19096961,19131929,34968
FBgn0038680,Cyp12a5,3R,19132648,19134704,2056
FBgn0038681,Cyp12a4,3R,19135158,19137136,1978
FBgn0002962,nanos,3R,19157238,19160202,2964
FBgn0010768,sqz,3R,19164211,19170576,6365
FBgn0038685,CG14282,3R,19177000,19177986,986
FBgn0051475,myd,3R,19180659,19201096,20437
FBgn0025680,cry,3R,19212154,19215442,3288
FBgn0038692,Polr2M,3R,19229463,19230832,1369
FBgn0038695,CG14280,3R,19256777,19260132,3355
FBgn0000463,Delta,3R,19302731,19326217,23486
FBgn0038694,CG5217,3R,19247052,19248136,1084
FBgn0038693,unc79,3R,19230764,19246130,15366
FBgn0038686,CG5555,3R,19178085,19180538,2453
FBgn0038678,mRpL55,3R,19094394,19094905,511
FBgn0038704,Aptx,3R,19403455,19406294,2839
FBgn0038705,CG11626,3R,19408873,19411265,2392
FBgn0038708,Scsalpha2,3R,19461879,19463066,1187
FBgn0038706,CG3517,3R,19423779,19425199,1420
FBgn0051244,CG31244,3R,19397430,19398567,1137
FBgn0038697,CG3581,3R,19373757,19374789,1032
FBgn0038716,CG7342,3R,19603375,19606475,3100
FBgn0038722,Nup58,3R,19645026,19646906,1880
FBgn0051220,CG31220,3R,19648487,19650586,2099
FBgn0051219,CG31219,3R,19651018,19652430,1412
FBgn0003011,ort,3R,19659748,19663672,3924
FBgn0051216,Naam,3R,19671450,19698742,27292
FBgn0038732,Acsx2,3R,19778750,19780727,1977
FBgn0038733,Acsx3,3R,19781246,19783145,1899
FBgn0038734,Acsx4,3R,19783522,19785519,1997
FBgn0038725,CG6184,3R,19652369,19657866,5497
FBgn0038723,CG6195,3R,19646930,19648410,1480
FBgn0038721,subdued,3R,19633418,19642722,9304
FBgn0038720,CG6231,3R,19616024,19632718,16694
FBgn0038735,MICU3,3R,19847311,19854403,7092
FBgn0038737,Mrm2,3R,19861610,19862600,990
FBgn0038739,CG4686,3R,19864496,19866869,2373
FBgn0038742,Arc42,3R,19877737,19879309,1572
FBgn0014006,Ask1,3R,19879719,19886030,6311
FBgn0038744,CG4733,3R,19890689,19898738,8049
FBgn0038747,RhoGAP92B,3R,19905164,19914272,9108
FBgn0038751,CG4770,3R,19918507,19920584,2077
FBgn0038756,CG4783,3R,19948443,19948907,464
FBgn0038760,MED25,3R,20008947,20011712,2765
FBgn0038766,CG4854,3R,20028058,20029561,1503
FBgn0038768,idc,3R,20031823,20034330,2507
FBgn0038772,mdlc,3R,20057748,20059291,1543
FBgn0038771,CG4390,3R,20056418,20059750,3332
FBgn0040571,CG17193,3R,20036421,20056097,19676
FBgn0038769,Regnase-1,3R,20033881,20036056,2175
FBgn0038767,trem,3R,20029560,20031309,1749
FBgn0038765,CG4424,3R,20026487,20028040,1553
FBgn0038763,PIG-L,3R,20018269,20021338,3069
FBgn0038761,CG17190,3R,20011776,20013504,1728
FBgn0038755,Hs6st,3R,19929277,20008512,79235
FBgn0021776,mira,3R,19931799,19935120,3321
FBgn0038753,CG4459,3R,19926322,19928644,2322
FBgn0038752,CG4462,3R,19921744,19925371,3627
FBgn0038750,CG4465,3R,19915868,19917839,1971
FBgn0038749,Xport-A,3R,19914396,19915412,1016
FBgn0038746,Surf6,3R,19903665,19904868,1203
FBgn0038745,ClpX,3R,19897372,19903689,6317
FBgn0002940,ninaE,3R,19886255,19888206,1951
FBgn0038741,CG17186,3R,19875974,19877514,1540
FBgn0038740,Mrp5,3R,19865417,19875678,10261
FBgn0038738,CG4572,3R,19862517,19864393,1876
FBgn0038774,CG5023,3R,20169435,20174872,5437
FBgn0051206,CG31206,3R,20106936,20107963,1027
FBgn0003249,Rh3,3R,20081060,20082450,1390
FBgn0038788,Sirt2,3R,20328465,20330915,2450
FBgn0038796,eIF3g2,3R,20408265,20409243,978
FBgn0038799,MFS9,3R,20507392,20512468,5076
FBgn0002869,MtnB,3R,20503102,20503746,644
FBgn0038797,Dic2,3R,20499992,20501427,1435
FBgn0038795,Tmlh,3R,20406615,20407871,1256
FBgn0038787,CG4360,3R,20324274,20328003,3729
FBgn0053192,MtnD,3R,20534962,20535301,339
FBgn0043457,CG5180,3R,20557930,20559760,1830
FBgn0038803,CG5191,3R,20560865,20573000,12135
FBgn0038806,CG5412,3R,20577053,20578131,1078
FBgn0038808,Srp14,3R,20580115,20580764,649
FBgn0038810,Srp72,3R,20588711,20591040,2329
FBgn0023097,bon,3R,20593139,20612540,19401
FBgn0038815,CG5466,3R,20617883,20621269,3386
FBgn0001169,H,3R,20621938,20628915,6977
FBgn0038816,Lrrk,3R,20635480,20644279,8799
FBgn0038819,Cpr92F,3R,20669571,20672821,3250
FBgn0051205,CG31205,3R,20731631,20732707,1076
FBgn0004107,Cdk2,3R,20735623,20738414,2791
FBgn0051200,CG31200,3R,20744234,20745338,1104
FBgn0051199,CG31199,3R,20742800,20743869,1069
FBgn0038821,CG17267,3R,20737325,20739100,1775
FBgn0024944,Oamb,3R,20689018,20714577,25559
FBgn0038820,CG4000,3R,20676224,20677351,1127
FBgn0038818,Nep4,3R,20652567,20659904,7337
FBgn0028422,GluRIID,3R,20648595,20652450,3855
FBgn0051201,GluRIIE,3R,20644154,20648716,4562
FBgn0015279,Pi3K92E,3R,20628972,20634732,5760
FBgn0038814,CG15923,3R,20611251,20616901,5650
FBgn0038811,Pus1,3R,20591024,20592671,1647
FBgn0014029,Septin2,3R,20586129,20588356,2227
FBgn0038809,CG16953,3R,20581770,20585833,4063
FBgn0023212,EloB,3R,20578222,20579850,1628
FBgn0038805,TFAM,3R,20575245,20577010,1765
FBgn0038804,CG10877,3R,20562486,20564067,1581
FBgn0040575,CG15922,3R,20559708,20560280,572
FBgn0038826,Syp,3R,20756729,20810726,53997
FBgn0019936,RpS20,3R,20822181,20823356,1175
FBgn0051223,CG31223,3R,20831127,20832455,1328
FBgn0053094,Synd,3R,20832799,20840118,7319
FBgn0038832,CG15695,3R,20842140,20844981,2841
FBgn0038833,CG15696,3R,20847068,20847748,680
FBgn0038834,RpS30,3R,20850516,20851427,911
FBgn0028396,TotA,3R,20871036,20871700,664
FBgn0044812,TotC,3R,20872988,20873580,592
FBgn0038838,TotB,3R,20873938,20874522,584
FBgn0038840,Grik,3R,20901956,20908263,6307
FBgn0038842,hdly,3R,20914296,20929213,14917
FBgn0051191,CG31191,3R,20909213,20945530,36317
FBgn0044810,TotX,3R,20904917,20905518,601
FBgn0038839,Ktl,3R,20894452,20897320,2868
FBgn0038837,KaiR1D,3R,20860187,20866231,6044
FBgn0027493,Adss,3R,20824667,20830580,5913
FBgn0038830,CG17272,3R,20823313,20824239,926
FBgn0038829,CG17271,3R,20819129,20821848,2719
FBgn0038828,CG17270,3R,20816445,20818929,2484
FBgn0038827,Fancd2,3R,20810804,20816190,5386
FBgn0051195,CG31195,3R,20757269,20762369,5100
FBgn0013995,Calx,3R,20978183,21015613,37430
FBgn0038846,CG5697,3R,21015949,21017120,1171
FBgn0026056,Rlip,3R,21017684,21020753,3069
FBgn0038847,CG12278,3R,21044068,21044905,837
FBgn0038851,dmrt93B,3R,21074007,21076798,2791
FBgn0038855,Tbc1d22,3R,21102199,21105113,2914
FBgn0028468,rtet,3R,21108446,21110834,2388
FBgn0015790,Rab11,3R,21111408,21116146,4738
FBgn0010770,ppan,3R,21116254,21117899,1645
FBgn0038858,CG5793,3R,21127573,21129601,2028
FBgn0038860,Ice2,3R,21130216,21132720,2504
FBgn0038862,Usp8,3R,21134262,21138214,3952
FBgn0038866,CG5810,3R,21163778,21165161,1383
FBgn0038865,cDIP,3R,21159238,21161092,1854
FBgn0038861,Trm7-34,3R,21132734,21133881,1147
FBgn0038857,Bdbt,3R,21117857,21118856,999
FBgn0038854,CG7044,3R,21098229,21101718,3489
FBgn0038853,RhoGAP93B,3R,21083043,21097827,14784
FBgn0003257,r-l,3R,21070557,21073319,2762
FBgn0025865,Cortactin,3R,21061680,21064471,2791
FBgn0038850,Jhbp15,3R,21050014,21050975,961
FBgn0038849,CG7079,3R,21047462,21048829,1367
FBgn0051207,CG31207,3R,21046032,21047027,995
FBgn0051189,CG31189,3R,21044898,21045842,944
FBgn0013812,Dhc93AB,3R,21024580,21042499,17919
FBgn0046763,peg,3R,21021044,21024163,3119
FBgn0038868,Ddrgk1,3R,21215079,21216226,1147
FBgn0038870,Oga,3R,21219077,21222843,3766
FBgn0038873,CG5892,3R,21242618,21245418,2800
FBgn0038874,ETHR,3R,21247011,21265134,18123
FBgn0038876,Idi,3R,21270126,21271408,1282
FBgn0001234,lncRNA:Hsromega,3R,21296127,21317836,21709
FBgn0002781,mod(mdg4),3R,21350846,21377401,26555
FBgn0004110,tin,3R,21378977,21381970,2993
FBgn0004862,bap,3R,21388880,21390449,1569
FBgn0038887,CG7907,3R,21403735,21406690,2955
FBgn0011278,lbe,3R,21441577,21446537,4960
FBgn0008651,lbl,3R,21409979,21434133,24154
FBgn0038881,aus,3R,21318300,21349601,31301
FBgn0038878,CG3301,3R,21274243,21276249,2006
FBgn0038877,CG3308,3R,21271078,21273817,2739
FBgn0043012,AP-2sigma,3R,21269209,21270075,866
FBgn0000527,e,3R,21229839,21237177,7338
FBgn0038871,CG3337,3R,21220704,21223584,2880
FBgn0038869,Smyd5,3R,21217268,21218791,1523
FBgn0038889,Fancm,3R,21482325,21487444,5119
FBgn0004863,C15,3R,21499986,21512814,12828
FBgn0038890,sp3,3R,21520928,21528598,7670
FBgn0038894,Jhbp16,3R,21664389,21666676,2287
FBgn0051176,CG31176,3R,21672303,21719660,47357
FBgn0011766,E2f1,3R,21620304,21660871,40567
FBgn0038892,CG15498,3R,21567519,21569149,1630
FBgn0002941,slou,3R,21548661,21557182,8521
FBgn0038897,CG5849,3R,21740105,21744431,4326
FBgn0051343,CG31343,3R,21745266,21749003,3737
FBgn0051233,CG31233,3R,21749853,21753237,3384
FBgn0051198,CG31198,3R,21754324,21757758,3434
FBgn0038902,CG6800,3R,21776138,21777213,1075
FBgn0041229,Gr93a,3R,21832503,21834013,1510
FBgn0051431,CG31431,3R,21870681,21873640,2959
FBgn0064912,CG31178,3R,21873739,21874922,1183
FBgn0038912,CG6656,3R,21875293,21877788,2495
FBgn0053092,P5CDh2,3R,21877936,21880696,2760
FBgn0051465,CG31465,3R,21880810,21883990,3180
FBgn0038917,CG6678,3R,21887029,21907182,20153
FBgn0038919,Qsox2,3R,21913747,21915546,1799
FBgn0038916,dnd,3R,21885676,21887355,1679
FBgn0038914,fit,3R,21883924,21884454,530
FBgn0051174,CG31174,3R,21868681,21869514,833
FBgn0038909,CG6569,3R,21866172,21867919,1747
FBgn0015229,glec,3R,21850694,21856266,5572
FBgn0045470,Gr93b,3R,21842521,21843765,1244
FBgn0013759,CASK,3R,21783400,21822674,39274
FBgn0003867,tsl,3R,21778114,21782536,4422
FBgn0038903,Polr1H,3R,21777203,21777847,644
FBgn0027575,GABA-B-R2,3R,21770333,21775840,5507
FBgn0038921,Theg,3R,22014697,22016212,1515
FBgn0038923,mRpL35,3R,22023527,22024341,814
FBgn0019957,ND-42,3R,22027709,22029393,1684
FBgn0038928,Fadd,3R,22034455,22035617,1162
FBgn0038929,CG13408,3R,22080382,22083473,3091
FBgn0040582,BomBc3,3R,22087075,22088501,1426
FBgn0038930,BomT3,3R,22085374,22086397,1023
FBgn0038927,CG6015,3R,22032150,22034286,2136
FBgn0038926,CG13409,3R,22029440,22031900,2460
FBgn0038925,Cchl,3R,22025975,22027480,1505
FBgn0038924,CG6028,3R,22024259,22025506,1247
FBgn0019960,Mitofilin,3R,22019505,22023335,3830
FBgn0038922,Idh3b,3R,22016391,22019382,2991
FBgn0051164,Ir94a,3R,22113427,22115214,1787
FBgn0051163,SKIP,3R,22133830,22296126,162296
FBgn0038934,Gld2,3R,22211824,22217415,5591
FBgn0038938,CG7084,3R,22298805,22304420,5615
FBgn0038946,rdhB,3R,22351696,22356264,4568
FBgn0038947,Sar1,3R,22356685,22360711,4026
FBgn0260467,CG7071,3R,22362620,22364580,1960
FBgn0038952,CG7069,3R,22372835,22375579,2744
FBgn0038953,CG18596,3R,22375923,22379955,4032
FBgn0038957,CG7059,3R,22389780,22392349,2569
FBgn0038959,CG13856,3R,22402655,22405059,2404
FBgn0038960,CG13855,3R,22405939,22408640,2701
FBgn0038965,mats,3R,22421161,22423302,2141
FBgn0038964,Nop56,3R,22419095,22421068,1973
FBgn0038961,CG13850,3R,22408566,22410915,2349
FBgn0038958,CG13857,3R,22392189,22394104,1915
FBgn0038956,CAH8,3R,22386489,22389714,3225
FBgn0038951,Polr3F,3R,22366080,22367373,1293
FBgn0038948,JMJD6,3R,22360782,22362371,1589
FBgn0038943,CG5391,3R,22333088,22334150,1062
FBgn0038972,CG7054,3R,22464985,22465938,953
FBgn0038973,Pebp1,3R,22466034,22466679,645
FBgn0038975,Nrx-1,3R,22468512,22486969,18457
FBgn0038976,Pfdn5,3R,22487039,22488110,1071
FBgn0038978,tHMG1,3R,22491829,22492381,552
FBgn0038979,tHMG2,3R,22492953,22493746,793
FBgn0053110,CG33110,3R,22570188,22580392,10204
FBgn0028837,CSN6,3R,22580773,22582033,1260
FBgn0038989,CG6937,3R,22584773,22586209,1436
FBgn0051158,Efa6,3R,22587755,22608842,21087
FBgn0038993,CG13843,3R,22609485,22610715,1230
FBgn0051159,mRRF2,3R,22613686,22616622,2936
FBgn0051161,CG31161,3R,22616511,22618300,1789
FBgn0020278,loco,3R,22619968,22639387,19419
FBgn0051156,CG31156,3R,22608670,22613656,4986
FBgn0053107,CG33107,3R,22583352,22584718,1366
FBgn0024558,Dph5,3R,22582028,22583225,1197
FBgn0038986,sit,3R,22558342,22562572,4230
FBgn0038984,AdipoR,3R,22543693,22547846,4153
FBgn0038983,CG5326,3R,22532174,22539919,7745
FBgn0053099,CG33099,3R,22528920,22530572,1652
FBgn0038981,CG5346,3R,22520087,22528663,8576
FBgn0003676,CCT1,3R,22489105,22491439,2334
FBgn0038977,CG5376,3R,22488033,22488955,922
FBgn0038974,CG5377,3R,22466905,22468157,1252
FBgn0028688,Rpn7,3R,22460662,22462054,1392
FBgn0038968,CG12499,3R,22440152,22446587,6435
FBgn0038967,CG13847,3R,22425214,22436150,10936
FBgn0038966,pinta,3R,22423316,22424929,1613
FBgn0039002,CG17625,3R,22686849,22687407,558
FBgn0039004,Nup133,3R,22690607,22694772,4165
FBgn0039006,Cyp6d4,3R,22698319,22700307,1988
FBgn0039008,CG6972,3R,22702007,22704338,2331
FBgn0039017,CG6985,3R,22741150,22743081,1931
FBgn0039019,HP1c,3R,22745620,22746605,985
FBgn0039025,Usp12-46,3R,22750901,22776374,25473
FBgn0039026,CG7029,3R,22750901,22794030,43129
FBgn0039027,CG7031,3R,22804291,22807290,2999
FBgn0039028,CG13840,3R,22814483,22816178,1695
FBgn0040588,CG13841,3R,22766732,22767699,967
FBgn0039024,Nepl15,3R,22763960,22766172,2212
FBgn0039023,Nepl14,3R,22761440,22763711,2271
FBgn0039022,Nepl13,3R,22758810,22761076,2266
FBgn0039016,Dcr-1,3R,22734007,22741091,7084
FBgn0039015,Takl2,3R,22732356,22733851,1495
FBgn0039013,RNF220,3R,22724884,22726414,1530
FBgn0024958,Irp-1A,3R,22721320,22724587,3267
FBgn0051151,wge,3R,22710883,22721150,10267
FBgn0039010,CG4907,3R,22707786,22710762,2976
FBgn0039009,CG13842,3R,22704254,22707278,3024
FBgn0039007,CCAP,3R,22700582,22702084,1502
FBgn0039003,wfs1,3R,22687542,22690380,2838
FBgn0046114,Gclm,3R,22685006,22686510,1504
FBgn0017590,klg,3R,22899284,22961731,62447
FBgn0039030,CG6660,3R,22923352,22924525,1173
FBgn0051281,Tpl94D,3R,22966284,22967842,1558
FBgn0039031,Gbp3,3R,22977270,22978164,894
FBgn0039033,Or94a,3R,22987281,22988503,1222
FBgn0039038,CG6688,3R,23012412,23015475,3063
FBgn0027526,Ublcp1,3R,23061493,23062751,1258
FBgn0039049,CG6726,3R,23091724,23095184,3460
FBgn0039050,CG17110,3R,23091724,23095441,3717
FBgn0039051,CG17109,3R,23095690,23097240,1550
FBgn0039052,CG6733,3R,23097728,23099191,1463
FBgn0039054,Cow,3R,23070516,23112730,42214
FBgn0039048,CG17111,3R,23062713,23067259,4546
FBgn0053193,sav,3R,23058609,23061304,2695
FBgn0039045,Ctns,3R,23054410,23058958,4548
FBgn0039044,p53,3R,23049657,23054082,4425
FBgn0039043,CG17121,3R,23044664,23048214,3550
FBgn0039040,CG13833,3R,23033284,23035563,2279
FBgn0039039,lmd,3R,23021222,23026713,5491
FBgn0039056,CenB1A,3R,23118400,23124217,5817
FBgn0039066,EloA,3R,23251563,23255071,3508
FBgn0039068,Pex11c,3R,23258365,23260602,2237
FBgn0025781,Cdc16,3R,23281201,23284123,2922
FBgn0039069,CG6763,3R,23284002,23286041,2039
FBgn0039071,bb8,3R,23288217,23290189,1972
FBgn0039070,wam,3R,23286093,23288051,1958
FBgn0039067,wda,3R,23255070,23258087,3017
FBgn0039065,Rad60,3R,23249443,23251477,2034
FBgn0039064,CG4467,3R,23227727,23248903,21176
FBgn0011596,fzo,3R,23201644,23204034,2390
FBgn0039058,VhaAC39-2,3R,23158017,23159316,1299
FBgn0004395,unk,3R,23149653,23157862,8209
FBgn0051457,CG31457,3R,23126581,23127981,1400
FBgn0051365,CG31365,3R,23123962,23126422,2460
FBgn0039055,Rassf,3R,23114014,23117931,3917
FBgn0024509,Sec13,3R,23356278,23358531,2253
FBgn0002622,RpS3,3R,23358812,23360207,1395
FBgn0051225,Ir94f,3R,23481865,23483541,1676
FBgn0039088,CG10164,3R,23554323,23556943,2620
FBgn0039084,CG10175,3R,23522264,23530986,8722
FBgn0039083,CG10177,3R,23520146,23521583,1437
FBgn0039081,Irk2,3R,23513617,23519445,5828
FBgn0039078,CG4374,3R,23408684,23472278,63594
FBgn0039075,CG4393,3R,23375928,23384777,8849
FBgn0039073,CG4408,3R,23361889,23363574,1685
FBgn0016119,ATPsynCF6,3R,23355220,23356064,844
FBgn0039089,beat-IV,3R,23557412,23580077,22665
FBgn0039098,GILT3,3R,23677358,23678421,1063
FBgn0039099,GILT2,3R,23678895,23679855,960
FBgn0039101,CG16710,3R,23682503,23683980,1477
FBgn0042106,CG18754,3R,23684057,23686537,2480
FBgn0039102,SPE,3R,23686255,23688147,1892
FBgn0051148,Gba1a,3R,23700621,23702605,1984
FBgn0051414,Gba1b,3R,23704804,23708512,3708
FBgn0039109,CG10365,3R,23723331,23731499,8168
FBgn0028684,Rpt5,3R,23752876,23754623,1747
FBgn0039111,PTPMT1,3R,23758339,23759606,1267
FBgn0039112,SdhD,3R,23759483,23760600,1117
FBgn0028475,Hrd3,3R,23754623,23758557,3934
FBgn0039110,RanBP3,3R,23750937,23752834,1897
FBgn0028691,Rpn9,3R,23731375,23733462,2087
FBgn0039108,CG10232,3R,23719343,23721625,2282
FBgn0002922,nau,3R,23712814,23718357,5543
FBgn0047351,CG31468,3R,23699328,23700354,1026
FBgn0043005,prt,3R,23696372,23699027,2655
FBgn0039104,CG10252,3R,23695221,23696245,1024
FBgn0027512,CG10254,3R,23689007,23694983,5976
FBgn0051145,CG31145,3R,23605751,23669659,63908
FBgn0039094,CG10184,3R,23602507,23605495,2988
FBgn0039125,Ndc1,3R,23924399,23926436,2037
FBgn0047114,CG31142,3R,23929243,23929988,745
FBgn0039128,CG13599,3R,23931639,23932728,1089
FBgn0039130,CG5854,3R,23933912,23935964,2052
FBgn0039132,AP-1sigma,3R,23958651,23962555,3904
FBgn0051140,CG31140,3R,23963180,23983232,20052
FBgn0051451,lncRNA:mimi,3R,23983503,23985065,1562
FBgn0039136,CG5902,3R,23986642,23988738,2096
FBgn0015795,Rab7,3R,23993008,23995452,2444
FBgn0053108,CG33108,3R,23995659,23997544,1885
FBgn0051184,LSm3,3R,23996262,23997017,755
FBgn0020647,KrT95D,3R,23997538,24031827,34289
FBgn0039137,Epp,3R,23988806,23992916,4110
FBgn0039135,CG13603,3R,23985213,23986569,1356
FBgn0005674,GluProRS,3R,23952136,23958391,6255
FBgn0039131,CG12268,3R,23943628,23948424,4796
FBgn0039129,RpS19b,3R,23932729,23933530,801
FBgn0015282,Rpt2,3R,23929873,23931558,1685
FBgn0039126,CG13601,3R,23926372,23927634,1262
FBgn0016754,sba,3R,23894174,23922973,28799
FBgn0039124,tbrd-1,3R,23891597,23893560,1963
FBgn0013347,TfIIA-S,3R,23890388,23891060,672
FBgn0025574,Pli,3R,23860162,23890052,29890
FBgn0039139,Mettl3,3R,24032157,24034257,2100
FBgn0039141,spas,3R,24038215,24042982,4767
FBgn0043455,CG5986,3R,24047790,24049168,1378
FBgn0026576,Pisd,3R,24050783,24053592,2809
FBgn0039145,CG6000,3R,24054391,24055092,701
FBgn0040283,SMC1,3R,24058287,24062815,4528
FBgn0039149,CG18428,3R,24109336,24110010,674
FBgn0039152,Root,3R,24113286,24128193,14907
FBgn0026317,Tsc1,3R,24130307,24134654,4347
FBgn0039154,Npc2f,3R,24137895,24140936,3041
FBgn0039155,Kal1,3R,24141395,24147490,6095
FBgn0039156,CG6178,3R,24152347,24154896,2549
FBgn0039158,TBC1d7,3R,24161727,24163215,1488
FBgn0026598,Apc2,3R,24163966,24168264,4298
FBgn0039161,CG13606,3R,24172628,24184144,11516
FBgn0029503,mora,3R,24186359,24187785,1426
FBgn0039165,CG6204,3R,24193832,24196880,3048
FBgn0026257,cav,3R,24221103,24223528,2425
FBgn0039170,CG13609,3R,24227023,24228538,1515
FBgn0002863,Acp95EF,3R,24228975,24229279,304
FBgn0043884,mask,3R,24230562,24250248,19686
FBgn0039172,Spase22-23,3R,24228342,24230035,1693
FBgn0039169,Spps,3R,24223445,24226934,3489
FBgn0011725,twin,3R,24196893,24221965,25072
FBgn0039167,CG17786,3R,24214631,24218718,4087
FBgn0039163,CG5515,3R,24187724,24188896,1172
FBgn0039160,CG5510,3R,24167675,24169562,1887
FBgn0039159,mRpS24,3R,24162829,24163545,716
FBgn0015765,p38a,3R,24150416,24152321,1905
FBgn0051133,Slimp,3R,24147436,24148967,1531
FBgn0039153,GatB,3R,24128049,24130255,2206
FBgn0039151,CG13607,3R,24114043,24116322,2279
FBgn0039150,CG13605,3R,24109944,24112389,2445
FBgn0053100,eIF4EHP,3R,24063077,24108960,45883
FBgn0013343,Syx1A,3R,24101600,24105763,4163
FBgn0001230,Hsp68,3R,24055080,24057310,2230
FBgn0005649,Rox8,3R,24043056,24048265,5209
FBgn0039140,Miro,3R,24034362,24038847,4485
FBgn0051130,tRNA:Leu-TAA-4-1,3R,24265259,24265342,83
FBgn0019952,Orct,3R,24276260,24278792,2532
FBgn0039178,CG6356,3R,24283955,24288617,4662
FBgn0011785,BRWD3,3R,24319000,24328619,9619
FBgn0039183,Dis3,3R,24333433,24337248,3815
FBgn0039184,CG6432,3R,24336922,24340645,3723
FBgn0011581,Ms,3R,24341551,24343825,2274
FBgn0039187,CG6454,3R,24349182,24356241,7059
FBgn0053340,CG33340,3R,24363138,24364289,1151
FBgn0039200,CG13616,3R,24392889,24393762,873
FBgn0000036,nAChRalpha1,3R,24393896,24457157,63261
FBgn0039198,CG5768,3R,24386104,24390339,4235
FBgn0039195,CG17782,3R,24370751,24372762,2011
FBgn0039190,CG5762,3R,24360705,24361683,978
FBgn0039189,CG18528,3R,24358095,24360144,2049
FBgn0039188,Golgin84,3R,24356070,24357938,1868
FBgn0039186,CG5746,3R,24343895,24348791,4896
FBgn0039182,Rrp5,3R,24328455,24333316,4861
FBgn0028471,Nab2,3R,24314660,24318419,3759
FBgn0039175,beta-PheRS,3R,24250460,24252679,2219
FBgn0000039,nAChRalpha2,3R,24485428,24491147,5719
FBgn0039201,DZIP1,3R,24515278,24518128,2850
FBgn0003134,Pp1alpha-96A,3R,24518270,24522331,4061
FBgn0039203,Jhbp12,3R,24524794,24527533,2739
FBgn0039204,CG6607,3R,24528047,24529815,1768
FBgn0004188,snRNA:U6:96Aa,3R,24556088,24556194,106
FBgn0039213,atl,3R,24625671,24634714,9043
FBgn0000139,ash2,3R,24650125,24653376,3251
FBgn0051126,CG31126,3R,24659621,24660265,644
FBgn0020018,Ppox,3R,24660197,24661851,1654
FBgn0051125,CG31125,3R,24653371,24654820,1449
FBgn0039214,puf,3R,24635270,24650043,14773
FBgn0046685,Wsck,3R,24627066,24630075,3009
FBgn0039212,Syx18,3R,24623802,24625562,1760
FBgn0039210,CG13625,3R,24583067,24585160,2093
FBgn0039209,REPTOR,3R,24557368,24582864,25496
FBgn0039205,CG13623,3R,24529773,24530558,785
FBgn0039202,CG13622,3R,24522478,24523678,1200
FBgn0004118,nAChRbeta2,3R,24509228,24515106,5878
FBgn0039217,CG13627,3R,24712780,24717430,4650
FBgn0039218,Polr2L,3R,24717511,24717998,487
FBgn0004885,tok,3R,24719697,24749125,29428
FBgn0003719,tld,3R,24749731,24753510,3779
FBgn0000140,asp,3R,24753849,24760513,6664
FBgn0040600,CG13631,3R,24769351,24770933,1582
FBgn0039225,Ets96B,3R,24788054,24797955,9901
FBgn0039232,sosie,3R,24833952,24840488,6536
FBgn0013953,Esp,3R,24841935,24850412,8477
FBgn0039233,CG7006,3R,24850627,24851385,758
FBgn0039234,Nct,3R,24851601,24854869,3268
FBgn0039238,CG7016,3R,24862931,24864216,1285
FBgn0013949,Elal,3R,24865350,24867651,2301
FBgn0039241,CG11089,3R,24877045,24881478,4433
FBgn0043799,CG31381,3R,24877045,24878827,1782
FBgn0039244,CG11069,3R,24894742,24897613,2871
FBgn0039249,CG11168,3R,24918106,24922385,4279
FBgn0039250,Mink,3R,24922473,24925160,2687
FBgn0039251,Trf4-2,3R,24925216,24927085,1869
FBgn0040601,CG13643,3R,24897685,24906004,8319
FBgn0051121,CG31121,3R,24881466,24894605,13139
FBgn0039240,CG3744,3R,24871202,24876654,5452
FBgn0015625,CycB3,3R,24867934,24870816,2882
FBgn0039239,Srg1,3R,24864191,24864732,541
FBgn0039237,CG13640,3R,24861659,24862165,506
FBgn0051105,ppk22,3R,24857585,24859801,2216
FBgn0039235,CAH4,3R,24856383,24857559,1176
FBgn0051119,HDAC11,3R,24854496,24856243,1747
FBgn0051357,Kaz,3R,24828279,24829959,1680
FBgn0051118,RabX4,3R,24826665,24828409,1744
FBgn0045980,niki,3R,24822401,24825648,3247
FBgn0027617,CG5808,3R,24814903,24817007,2104
FBgn0027539,lili,3R,24805445,24814012,8567
FBgn0039227,polybromo,3R,24799967,24805259,5292
FBgn0039226,Ude,3R,24797460,24799668,2208
FBgn0039224,CG13634,3R,24788248,24790136,1888
FBgn0039223,CG5805,3R,24784552,24787421,2869
FBgn0015591,AstA,3R,24760530,24765071,4541
FBgn0039219,CG13630,3R,24717937,24719364,1427
FBgn0039252,CG11771,3R,24932010,24934919,2909
FBgn0039254,Nmnat,3R,24945237,24947400,2163
FBgn0039257,tnc,3R,24984384,25022867,38483
FBgn0039258,beta4GalT7,3R,25023256,25024482,1226
FBgn0015240,Hr96,3R,25025235,25029351,4116
FBgn0051115,CG31115,3R,25036944,25037982,1038
FBgn0045866,bai,3R,25039374,25040443,1069
FBgn0039265,CG11790,3R,25047706,25049455,1749
FBgn0039266,CG11791,3R,25049616,25053074,3458
FBgn0039270,PQBP1,3R,25065791,25066718,927
FBgn0039271,CG11839,3R,25069927,25070914,987
FBgn0039272,CG11836,3R,25071126,25072712,1586
FBgn0039274,CG11920,3R,25074877,25076382,1505
FBgn0004897,fd96Ca,3R,25082684,25084878,2194
FBgn0004898,fd96Cb,3R,25095012,25096099,1087
FBgn0046214,vig2,3R,25123373,25125619,2246
FBgn0039282,Bili,3R,25131306,25136709,5403
FBgn0039283,danr,3R,25138072,25139903,1831
FBgn0039280,Mocs2B,3R,25125632,25127359,1727
FBgn0051510,CG31510,3R,25117218,25122920,5702
FBgn0039277,Nepl16,3R,25109226,25112516,3290
FBgn0039273,shams,3R,25072729,25074607,1878
FBgn0011336,Stt3B,3R,25066712,25069637,2925
FBgn0039269,veli,3R,25064418,25065591,1173
FBgn0051111,CG31111,3R,25055076,25056177,1101
FBgn0051109,CG31109,3R,25053369,25054653,1284
FBgn0039261,Ythdf,3R,25033876,25039249,5373
FBgn0039260,Smg6,3R,25029429,25033465,4036
FBgn0039259,EMC6,3R,25024473,25025017,544
FBgn0029157,ssh,3R,24938710,24944956,6246
FBgn0020626,Osbp,3R,24934869,24938222,3353
FBgn0051108,TTLL5,3R,25112867,25122920,10053
FBgn0039286,dan,3R,25184383,25192806,8423
FBgn0039290,CG13654,3R,25199818,25214255,14437
FBgn0051106,CG31106,3R,25216297,25218708,2411
FBgn0051103,CG31103,3R,25219318,25221444,2126
FBgn0039293,Alg9,3R,25221589,25224118,2529
FBgn0039297,Jhbp7,3R,25237614,25238895,1281
FBgn0039298,to,3R,25240180,25241668,1488
FBgn0039299,CG11854,3R,25242020,25243262,1242
FBgn0039301,Nup37,3R,25247658,25249100,1442
FBgn0039302,Nup358,3R,25249348,25258672,9324
FBgn0039303,CG11857,3R,25258898,25260759,1861
FBgn0039305,CG11858,3R,25262741,25263292,551
FBgn0039306,RIOK2,3R,25265844,25267757,1913
FBgn0039307,CR13656,3R,25268661,25269965,1304
FBgn0039310,CG11878,3R,25273837,25275237,1400
FBgn0051300,CG31300,3R,25283620,25285224,1604
FBgn0051104,CG31104,3R,25285473,25286974,1501
FBgn0039315,CG13658,3R,25287474,25288930,1456
FBgn0039316,CG11893,3R,25289889,25291366,1477
FBgn0039319,CG13659,3R,25300891,25302317,1426
FBgn0051370,CG31370,3R,25302464,25303986,1522
FBgn0051436,CG31436,3R,25304137,25305651,1514
FBgn0028647,CG11902,3R,25335257,25340088,4831
FBgn0027376,rha,3R,25340252,25344838,4586
FBgn0039335,Vps33B,3R,25473490,25475756,2266
FBgn0039337,MED28,3R,25477003,25477745,742
FBgn0039338,XNP,3R,25477868,25482834,4966
FBgn0039336,CG4553,3R,25475636,25476915,1279
FBgn0039329,CG10669,3R,25331363,25335243,3880
FBgn0039328,CHKov2,3R,25329530,25331203,1673
FBgn0045761,CHKov1,3R,25323156,25329316,6160
FBgn0039326,CG10562,3R,25321053,25322757,1704
FBgn0039325,CG10560,3R,25318550,25320101,1551
FBgn0039324,CG10553,3R,25316461,25318111,1650
FBgn0039323,CG10559,3R,25314494,25316116,1622
FBgn0039321,CG10550,3R,25306407,25308391,1984
FBgn0051288,CG31288,3R,25297960,25299557,1597
FBgn0051097,CG31097,3R,25296128,25297778,1650
FBgn0051102,CG31102,3R,25293458,25295594,2136
FBgn0051098,CG31098,3R,25291370,25292977,1607
FBgn0039312,CG10514,3R,25278427,25279846,1419
FBgn0039311,CG10513,3R,25275790,25277212,1422
FBgn0027090,GlnRS,3R,25263267,25265721,2454
FBgn0039304,Kdsr,3R,25260963,25262498,1535
FBgn0039300,RpS27,3R,25245955,25247514,1559
FBgn0039296,Sil1,3R,25233636,25235529,1893
FBgn0039294,Cad96Cb,3R,25224156,25232321,8165
FBgn0039291,Saysd1,3R,25214325,25215188,863
FBgn0022800,Cad96Ca,3R,25197571,25208283,10712
FBgn0039339,CG5116,3R,25483098,25485855,2757
FBgn0039341,CG5112,3R,25491460,25493262,1802
FBgn0039342,CG5107,3R,25505191,25505931,740
FBgn0039343,CG5111,3R,25506275,25508279,2004
FBgn0011666,msi,3R,25516118,25608423,92305
FBgn0039346,CG5079,3R,25613666,25614451,785
FBgn0039347,CG5071,3R,25618414,25621838,3424
FBgn0039350,jigr1,3R,25637843,25651874,14031
FBgn0027508,Tnks,3R,25653091,25661286,8195
FBgn0039344,CG4582,3R,25581223,25583179,1956
FBgn0040212,Gnpat,3R,25485618,25490936,5318
FBgn0039354,Lgr3,3R,25665809,25677214,11405
FBgn0039356,CG5039,3R,25678683,25679529,846
FBgn0039358,Idh3g,3R,25680845,25683780,2935
FBgn0039376,CG14354,3R,25815479,25816574,1095
FBgn0039379,CG5886,3R,25851632,25853989,2357
FBgn0039380,CG5890,3R,25856154,25872670,16516
FBgn0039381,SppL,3R,25881984,25888230,6246
FBgn0027865,Tsp96F,3R,25872900,25881427,8527
FBgn0011668,Mst57Da,3R,25831575,25831899,324
FBgn0051380,CG31380,3R,25787997,25789455,1458
FBgn0066101,LpR1,3R,25741348,25763105,21757
FBgn0051092,LpR2,3R,25698727,25740465,41738
FBgn0039360,CLS,3R,25685236,25687370,2134
FBgn0039359,RpL27,3R,25683623,25685051,1428
FBgn0039357,CG4743,3R,25679242,25680550,1308
FBgn0039355,CG4730,3R,25677072,25678682,1610
FBgn0028717,Lnk,3R,25888542,25893270,4728
FBgn0039385,CG5913,3R,25893495,25895026,1531
FBgn0039386,Sodq,3R,25895822,25897174,1352
FBgn0039398,CG14540,3R,25959279,25961686,2407
FBgn0000206,boss,3R,25961994,25966948,4954
FBgn0002732,E(spl)malpha-BFM,3R,26010893,26011568,675
FBgn0002578,Kaz-m1,3R,26014721,26016487,1766
FBgn0002609,E(spl)m3-HLH,3R,26021823,26023127,1304
FBgn0002633,E(spl)m7-HLH,3R,26037038,26038019,981
FBgn0001139,gro,3R,26041736,26049911,8175
FBgn0039402,Vps2,3R,26052821,26054128,1307
FBgn0039404,CG14543,3R,26056630,26057350,720
FBgn0039407,Trmt61,3R,26059496,26061293,1797
FBgn0039411,dysf,3R,26076592,26098711,22119
FBgn0039406,RpL34a,3R,26058420,26059267,847
FBgn0039405,PIG-P,3R,26057347,26058223,876
FBgn0039403,Sld5,3R,26055657,26056547,890
FBgn0028833,Cmpk,3R,26054237,26055438,1201
FBgn0002592,E(spl)m2-BFM,3R,26016514,26017470,956
FBgn0002733,E(spl)mbeta-HLH,3R,26005046,26006023,977
FBgn0039413,CG14556,3R,26126659,26127868,1209
FBgn0039415,CG6142,3R,26133154,26137148,3994
FBgn0051323,CG31323,3R,26170847,26187307,16460
FBgn0051086,CG31086,3R,26185251,26186227,976
FBgn0039419,CG12290,3R,26230248,26234700,4452
FBgn0039420,CG6154,3R,26262662,26277050,14388
FBgn0000064,Ald1,3R,26254069,26261591,7522
FBgn0039417,CG6073,3R,26187018,26188807,1789
FBgn0039425,Ald2,3R,26414088,26416192,2104
FBgn0051084,asRNA:CR31084,3R,26425354,26428408,3054
FBgn0042710,Hex-t2,3R,26450671,26452327,1656
FBgn0039427,CG5447,3R,26452534,26454585,2051
FBgn0039429,CG14238,3R,26458249,26460981,2732
FBgn0039430,CG5455,3R,26461527,26470008,8481
FBgn0039431,plum,3R,26470078,26535217,65139
FBgn0023178,Pdf,3R,26455462,26456141,679
FBgn0039424,ppk15,3R,26401909,26403656,1747
FBgn0039421,Nil,3R,26344290,26345473,1183
FBgn0040607,CG14244,3R,26726133,26726681,548
FBgn0039451,CG6420,3R,26719847,26725216,5369
FBgn0039449,CG6425,3R,26715165,26717389,2224
FBgn0023179,amon,3R,26697697,26714159,16462
FBgn0039459,IntS12,3R,26863376,26864559,1183
FBgn0001197,His2Av,3R,26866929,26869220,2291
FBgn0039461,CG5500,3R,26876630,26880459,3829
FBgn0004359,T48,3R,26881734,26910997,29263
FBgn0039462,CG14252,3R,26945534,26947248,1714
FBgn0039463,Spag1,3R,26947830,26949682,1852
FBgn0039466,CG5521,3R,26966930,26977878,10948
FBgn0039467,CG14253,3R,26978541,26985706,7165
FBgn0051077,CG31077,3R,26999752,27002961,3209
FBgn0039471,CG6295,3R,27005899,27007055,1156
FBgn0051076,CG31076,3R,26989035,26989852,817
FBgn0051075,CG31075,3R,26985624,26988517,2893
FBgn0039465,Tsp97E,3R,26961064,26964817,3753
FBgn0039464,CG6330,3R,26949692,26958491,8799
FBgn0004510,Ets97D,3R,26910775,26912886,2111
FBgn0003267,ro,3R,26876771,26881171,4400
FBgn0026562,SPARC,3R,26869238,26871995,2757
FBgn0027889,ball,3R,26864605,26866807,2202
FBgn0004842,RYa-R,3R,26996980,27057935,60955
FBgn0029170,TwdlT,3R,27049220,27051004,1784
FBgn0039479,CG14257,3R,27075870,27082818,6948
FBgn0039482,CG14258,3R,27093143,27094224,1081
FBgn0039483,CG14259,3R,27094533,27095856,1323
FBgn0039485,Jhbp11,3R,27101230,27102917,1687
FBgn0027574,CG5815,3R,27112566,27115126,2560
FBgn0039489,CG5880,3R,27116745,27118532,1787
FBgn0039490,CG5882,3R,27118646,27121590,2944
FBgn0029155,Men-b,3R,27151662,27157603,5941
FBgn0039494,grass,3R,27157948,27159781,1833
FBgn0039495,CG5909,3R,27161158,27162911,1753
FBgn0003482,spn-D,3R,27165716,27167122,1406
FBgn0051068,CG31068,3R,27233698,27236360,2662
FBgn0005696,PolA2,3R,27239163,27241228,2065
FBgn0042111,CG18766,3R,27242335,27245249,2914
FBgn0051064,CG31064,3R,27229505,27239085,9580
FBgn0004197,Ser,3R,27172090,27194267,22177
FBgn0039492,CG6051,3R,27124759,27151069,26310
FBgn0039491,CG6059,3R,27121618,27124688,3070
FBgn0039488,CG6066,3R,27115152,27116707,1555
FBgn0039487,gb,3R,27108467,27112270,3803
FBgn0039486,CAH9,3R,27102988,27106184,3196
FBgn0039481,Cpr97Eb,3R,27089704,27091130,1426
FBgn0039480,Cpr97Ea,3R,27083130,27087778,4648
FBgn0003495,spz,3R,27064990,27070070,5080
FBgn0039478,Nep5,3R,27057908,27064199,6291
FBgn0011289,TfIIA-L,3R,27251112,27256463,5351
FBgn0039504,CG14260,3R,27265457,27266423,966
FBgn0039505,CG5934,3R,27273705,27274565,860
FBgn0046247,CG5938,3R,27274794,27277418,2624
FBgn0039508,CG3368,3R,27283780,27287448,3668
FBgn0015737,Hmu,3R,27288769,27291592,2823
FBgn0016061,side,3R,27375088,27437482,62394
FBgn0039511,CG3330,3R,27329693,27330882,1189
FBgn0039510,CG3339,3R,27294286,27322325,28039
FBgn0040609,CG3348,3R,27291535,27292209,674
FBgn0039509,bigmax,3R,27287366,27288526,1160
FBgn0039507,mrt,3R,27277249,27282661,5412
FBgn0002441,l(3)mbt,3R,27266326,27273273,6947
FBgn0010328,woc,3R,27256595,27264055,7460
FBgn0010441,pll,3R,27251131,27253182,2051
FBgn0039501,TTLL6B,3R,27248234,27251007,2773
FBgn0039500,CG5984,3R,27246403,27247992,1589
FBgn0039518,CG13978,3R,27464189,27467080,2891
FBgn0039520,Gr98a,3R,27487927,27489968,2041
FBgn0039523,CG12885,3R,27520866,27533934,13068
FBgn0046887,Gr98b,3R,27542497,27543888,1391
FBgn0046885,Gr98d,3R,27546052,27547462,1410
FBgn0040080,pins,3R,27582840,27586376,3536
FBgn0039528,dsd,3R,27597563,27607396,9833
FBgn0039527,CG5639,3R,27586474,27596130,9656
FBgn0027492,wdb,3R,27561675,27582241,20566
FBgn0039525,CG5646,3R,27559379,27561319,1940
FBgn0004387,Klp98A,3R,27547775,27559145,11370
FBgn0005659,Ets98B,3R,27736538,27748366,11828
FBgn0039552,CG12426,3R,27871501,27872390,889
FBgn0039555,mRpS22,3R,27916908,27918248,1340
FBgn0003279,RpL4,3R,27922821,27924888,2067
FBgn0027579,mino,3R,27925191,27933077,7886
FBgn0039560,BOD1,3R,27938245,27942778,4533
FBgn0039562,Gp93,3R,27948711,27952151,3440
FBgn0039564,Nep7,3R,27954917,27957326,2409
FBgn0051054,CR31054,3R,27960768,27961476,708
FBgn0039566,CG4849,3R,27963415,27966958,3543
FBgn0039568,CG4815,3R,27989699,27990751,1052
FBgn0003890,betaTub97EF,3R,27967008,27988384,21376
FBgn0039565,CG4884,3R,27957356,27959245,1889
FBgn0039563,CG4951,3R,27952051,27954112,2061
FBgn0039561,mfrn,3R,27942796,27948021,5225
FBgn0039559,NSD,3R,27932982,27937853,4871
FBgn0051053,nenya,3R,27927357,27928174,817
FBgn0039558,BCAS2,3R,27921283,27922356,1073
FBgn0039557,CG12259,3R,27919844,27921089,1245
FBgn0053213,Boh1,3R,27918182,27919460,1278
FBgn0039554,CG5003,3R,27913777,27916516,2739
FBgn0002865,Mst98Ca,3R,28291338,28292656,1318
FBgn0004171,Mst98Cb,3R,28292798,28293863,1065
FBgn0039581,Moca-cyp,3R,28340334,28345169,4835
FBgn0039584,beat-VI,3R,28418208,28474814,56606
FBgn0013813,Dhc98D,3R,28486953,28519398,32445
FBgn0039588,mIF2,3R,28542274,28544817,2543
FBgn0003137,Ppn,3R,28520665,28540324,19659
FBgn0051051,CG31051,3R,28519548,28520515,967
FBgn0039580,Gfat2,3R,28337019,28339765,2746
FBgn0001215,Hrb98DE,3R,28599834,28605777,5943
FBgn0039589,CG9986,3R,28606079,28608372,2293
FBgn0039593,Sid,3R,28670704,28672021,1317
FBgn0039594,snu,3R,28675041,28695939,20898
FBgn0027655,htt,3R,28696242,28734816,38574
FBgn0039595,AstA-R2,3R,28737109,28744782,7673
FBgn0039590,CG10011,3R,28607939,28635099,27160
FBgn0026400,Noa36,3R,28598059,28599288,1229
FBgn0000659,fkh,3R,28580976,28585264,4288
FBgn0039600,Prp39,3R,28812102,28817354,5252
FBgn0039602,CG1647,3R,28820221,28824508,4287
FBgn0039609,Nepl17,3R,28872905,28875031,2126
FBgn0039611,Nepl18,3R,28875621,28877805,2184
FBgn0039613,Nepl20,3R,28880792,28882945,2153
FBgn0027578,Nepl21,3R,28883693,28886015,2322
FBgn0039616,CG11828,3R,28923044,28925086,2042
FBgn0039623,CG1951,3R,29027236,29030938,3702
FBgn0041780,Ssl2,3R,29030951,29032642,1691
FBgn0039622,eIF4E6,3R,29026439,29027174,735
FBgn0039620,wat,3R,28992977,29020406,27429
FBgn0039617,DIP-gamma,3R,28925004,28970372,45368
FBgn0053203,CG33203,3R,28870606,28887709,17103
FBgn0039612,Nepl19,3R,28878024,28880122,2098
FBgn0015589,Apc,3R,28832301,28844748,12447
FBgn0024273,WASp,3R,28824506,28832024,7518
FBgn0039601,CG1523,3R,28817342,28819668,2326
FBgn0005642,wdn,3R,28807983,28811337,3354
FBgn0027873,Cpsf100,3R,29034573,29037062,2489
FBgn0003093,Pkc98E,3R,29039156,29049148,9992
FBgn0039627,CG11837,3R,29049493,29050721,1228
FBgn0039628,CG11841,3R,29051056,29052267,1211
FBgn0039629,CG11842,3R,29052680,29053913,1233
FBgn0039630,CG11843,3R,29054347,29055837,1490
FBgn0039631,Sirt7,3R,29055927,29059204,3277
FBgn0039633,Bicra,3R,29063040,29108948,45908
FBgn0039635,Pdhb,3R,29113071,29116197,3126
FBgn0039636,Atg14,3R,29116391,29118390,1999
FBgn0039637,Ctl2,3R,29123370,29128247,4877
FBgn0028671,Vha100-1,3R,29131193,29137980,6787
FBgn0039640,superdeath,3R,29138662,29145787,7125
FBgn0028692,Rpn2,3R,29153524,29157255,3731
FBgn0039644,rdog,3R,29158122,29164966,6844
FBgn0039645,CG11898,3R,29165643,29171508,5865
FBgn0014427,CG11899,3R,29200454,29201770,1316
FBgn0051044,lncRNA:CR31044,3R,29214562,29219667,5105
FBgn0029176,eEF1gamma,3R,29220172,29222109,1937
FBgn0039654,Brd8,3R,29223485,29226276,2791
FBgn0028476,Usp1,3R,29229161,29235302,6141
FBgn0003525,stg,3R,29251826,29255800,3974
FBgn0051445,CG31445,3R,29240580,29244827,4247
FBgn0051427,CR31427,3R,29238830,29240308,1478
FBgn0039656,CG11951,3R,29235322,29238723,3401
FBgn0039655,CG14507,3R,29226204,29227725,1521
FBgn0062442,Cisd2,3R,29222217,29223428,1211
FBgn0039651,Cyt-c1L,3R,29202660,29204133,1473
FBgn0039650,Mesh1,3R,29201756,29202525,769
FBgn0039647,jus,3R,29171191,29194994,23803
FBgn0041186,Slbp,3R,29152074,29153266,1192
FBgn0041588,eIF2D,3R,29149896,29151794,1898
FBgn0039642,CG11882,3R,29147016,29148172,1156
FBgn0039641,CG14511,3R,29145678,29146893,1215
FBgn0039639,Alg13,3R,29137970,29138573,603
FBgn0039638,dgt6,3R,29128584,29130972,2388
FBgn0005596,yem,3R,29118330,29122879,4549
FBgn0039634,alpha-Man-Ib,3R,29109053,29112822,3769
FBgn0039626,Slu7,3R,29037058,29039071,2013
FBgn0039625,beta4GalNAcTB,3R,29032660,29034008,1348
FBgn0039664,CG2006,3R,29489468,29491383,1915
FBgn0039666,Diedel,3R,29493852,29494267,415
FBgn0039667,FipoQ,3R,29494782,29498923,4141
FBgn0039668,Trc8,3R,29499025,29503797,4772
FBgn0039665,CG2310,3R,29491524,29493518,1994
FBgn0040623,Spase12,3R,29490544,29491150,606
FBgn0039663,CG2321,3R,29484783,29489265,4482
FBgn0015622,Cnx99A,3R,29315254,29319644,4390
FBgn0000492,Dr,3R,29556386,29565244,8858
FBgn0039674,CG1907,3R,29619065,29620758,1693
FBgn0039677,ppk30,3R,29669149,29671478,2329
FBgn0039678,Obp99a,3R,29671657,29672334,677
FBgn0039679,ppk19,3R,29672456,29674223,1767
FBgn0039680,Cap-D2,3R,29675651,29680257,4606
FBgn0013972,Gycalpha99B,3R,29682503,29685758,3255
FBgn0039683,dmrt99B,3R,29692591,29697025,4434
FBgn0039684,Obp99d,3R,29714505,29715004,499
FBgn0039686,CG15506,3R,29718663,29722388,3725
FBgn0024841,Pcd,3R,29723163,29724226,1063
FBgn0042213,CG18731,3R,29725027,29725690,663
FBgn0039688,Kul,3R,29725830,29735360,9530
FBgn0039687,Naa40,3R,29724159,29724950,791
FBgn0039685,Obp99b,3R,29716254,29716896,642
FBgn0039682,Obp99c,3R,29685736,29689311,3575
FBgn0039681,CG7582,3R,29680241,29682278,2037
FBgn0025457,Bub3,3R,29674007,29675421,1414
FBgn0039673,CG7568,3R,29598670,29600862,2192
FBgn0039670,CG7567,3R,29587237,29588104,867
FBgn0039689,CIA30,3R,29736965,29738070,1105
FBgn0039690,Gnpnat,3R,29738275,29741952,3677
FBgn0039691,IntS11,3R,29745337,29747513,2176
FBgn0019972,Drice,3R,29799658,29801584,1926
FBgn0039698,CG7789,3R,29803196,29804389,1193
FBgn0000247,ca,3R,29806811,29815047,8236
FBgn0039704,neo,3R,29819131,29825800,6669
FBgn0039707,Prtl99C,3R,29835950,29837447,1497
FBgn0039709,Cad99C,3R,29841657,29854699,13042
FBgn0051038,CG31038,3R,29877059,29903231,26172
FBgn0039719,CG15515,3R,29905464,29906448,984
FBgn0051036,CG31036,3R,29908107,29912892,4785
FBgn0003357,Jon99Ciii,3R,29922216,29923455,1239
FBgn0039723,CG15522,3R,29927255,29928766,1511
FBgn0039727,Vps13B,3R,29935978,29948207,12229
FBgn0004622,TkR99D,3R,29950796,29969447,18651
FBgn0039726,eIF2Balpha,3R,29934582,29935888,1306
FBgn0051040,Cog7,3R,29930551,29933057,2506
FBgn0051202,alpha-Man-Ic,3R,29928701,29930386,1685
FBgn0003358,Jon99Ci,3R,29925226,29926189,963
FBgn0003356,Jon99Cii,3R,29923754,29924615,861
FBgn0003861,trp,3R,29914521,29920289,5768
FBgn0039722,Capa,3R,29912991,29914346,1355
FBgn0039712,CG15514,3R,29860055,29861494,1439
FBgn0051032,CR31032,3R,29859041,29859865,824
FBgn0039710,dgt1,3R,29854695,29857491,2796
FBgn0039705,Atg16,3R,29827281,29835101,7820
FBgn0039703,CG7829,3R,29816738,29817764,1026
FBgn0039702,Vps16B,3R,29814921,29816451,1530
FBgn0002924,ncd,3R,29804290,29807127,2837
FBgn0039697,Etfb,3R,29801599,29802945,1346
FBgn0039696,Rnb,3R,29795697,29799354,3657
FBgn0039694,fig,3R,29779273,29780452,1179
FBgn0020235,ATPsyngamma,3R,29747704,29749163,1459
FBgn0027518,Wdr24,3R,29741972,29745092,3120
FBgn0027583,CG7601,3R,29735269,29736745,1476
FBgn0039728,CG7896,3R,29983426,29990785,7359
FBgn0039731,Sas-6,3R,29995357,29997034,1677
FBgn0039733,CG11504,3R,29997900,29999755,1855
FBgn0039734,Tace,3R,30000530,30003678,3148
FBgn0016685,Nlp,3R,30004785,30010352,5567
FBgn0026597,Axn,3R,30022842,30035311,12469
FBgn0003511,Sry-beta,3R,30039719,30043071,3352
FBgn0003510,Sry-alpha,3R,30039719,30043071,3352
FBgn0003512,Sry-delta,3R,30043341,30044886,1545
FBgn0039741,CG7943,3R,30046470,30048665,2195
FBgn0039743,Jasper,3R,30052514,30054697,2183
FBgn0260468,CG7950,3R,30056859,30058131,1272
FBgn0039748,CG15529,3R,30152059,30153699,1640
FBgn0039752,CG15530,3R,30177877,30180178,2301
FBgn0039756,CG9743,3R,30196360,30202998,6638
FBgn0039755,CG15531,3R,30194790,30196228,1438
FBgn0039754,CG9747,3R,30185423,30191252,5829
FBgn0039751,CG1983,3R,30175786,30177700,1914
FBgn0051028,Rsod,3R,30166631,30171207,4576
FBgn0051030,VhaAC45RP,3R,30164692,30166419,1727
FBgn0039749,CG11498,3R,30153022,30160473,7451
FBgn0039747,AdoR,3R,30134856,30149606,14750
FBgn0051029,CG31029,3R,30129279,30132395,3116
FBgn0051025,Ppi1,3R,30125633,30129119,3486
FBgn0003479,spn-A,3R,30054696,30056037,1341
FBgn0039742,CG15528,3R,30048635,30052112,3477
FBgn0002626,RpL32,3R,30045229,30046161,932
FBgn0001280,janA,3R,30038622,30039533,911
FBgn0001281,janB,3R,30037984,30038728,744
FBgn0041102,ocn,3R,30037003,30037730,727
FBgn0039740,ZIPIC,3R,30035240,30036870,1630
FBgn0039737,CG7920,3R,30010476,30015284,4808
FBgn0039735,Nph,3R,30003681,30004861,1180
FBgn0039732,CG15525,3R,29996961,29997676,715
FBgn0039730,CG7903,3R,29993475,29995231,1756
FBgn0000032,Acph-1,3R,29991144,29993411,2267
FBgn0000279,CecC,3R,30216484,30216938,454
FBgn0010113,heca,3R,30277932,30372382,94450
FBgn0015221,Fer2LCH,3R,30387804,30390584,2780
FBgn0039765,mRpS18C,3R,30423974,30424556,582
FBgn0039767,CG2218,3R,30425427,30428276,2849
FBgn0039766,CG15536,3R,30424499,30425162,663
FBgn0039764,CG15535,3R,30423032,30423929,897
FBgn0027544,CG2217,3R,30418767,30422971,4204
FBgn0015222,Fer1HCH,3R,30385573,30388178,2605
FBgn0039759,CG9733,3R,30243978,30246703,2725
FBgn0039758,CG9737,3R,30241268,30243312,2044
FBgn0039774,CDase,3R,30459521,30465736,6215
FBgn0039776,PH4alphaEFB,3R,30466050,30485799,19749
FBgn0260440,spdo,3R,30476684,30478849,2165
FBgn0039778,Jon99Fi,3R,30488963,30489895,932
FBgn0039779,PH4alphaSG2,3R,30490074,30491987,1913
FBgn0039782,CG15539,3R,30505987,30507977,1990
FBgn0039784,CG9698,3R,30514777,30516980,2203
FBgn0082582,tmod,3R,30532607,30578905,46298
FBgn0039787,CG9702,3R,30579429,30582117,2688
FBgn0051019,CG31019,3R,30597004,30599296,2292
FBgn0039792,CG2267,3R,30627241,30629028,1787
FBgn0039790,CG2246,3R,30592971,30601489,8518
FBgn0039789,CG9717,3R,30584020,30587302,3282
FBgn0039788,Rpt6R,3R,30582198,30583697,1499
FBgn0027654,jdp,3R,30517059,30527037,9978
FBgn0051371,CG31371,3R,30501124,30503506,2382
FBgn0039780,PH4alphaNE1,3R,30496751,30500326,3575
FBgn0026190,PH4alphaMP,3R,30491813,30496153,4340
FBgn0039777,Jon99Fii,3R,30487016,30487928,912
FBgn0039773,CG2224,3R,30456441,30459300,2859
FBgn0028646,aralar1,3R,30445635,30455867,10232
FBgn0039771,Osi23,3R,30444076,30445046,970
FBgn0039770,CG15537,3R,30435177,30443599,8422
FBgn0039797,eIF4H2,3R,30726087,30728052,1965
FBgn0039799,CG15543,3R,30742880,30744474,1594
FBgn0039802,dj-1beta,3R,30807117,30807978,861
FBgn0027598,cindr,3R,30808617,30827005,18388
FBgn0039804,CG15544,3R,30827819,30842034,14215
FBgn0039805,Cpr100A,3R,30867521,30869184,1663
FBgn0015032,Cyp4c3,3R,30894038,30900688,6650
FBgn0000416,Sap-r,3R,30883464,30889062,5598
FBgn0039809,CG15547,3R,30881792,30883503,1711
FBgn0039808,CG12071,3R,30877084,30881027,3943
FBgn0039807,CG15546,3R,30874365,30876186,1821
FBgn0039806,CG15545,3R,30870939,30872351,1412
FBgn0011739,wts,3R,30789625,30806619,16994
FBgn0039801,Npc2h,3R,30745479,30746290,811
FBgn0039800,Npc2g,3R,30744605,30745263,658
FBgn0039798,CG11313,3R,30729837,30731165,1328
FBgn0000274,Pka-C2,3R,30695537,30697138,1601
FBgn0039796,CG12069,3R,30693572,30695498,1926
FBgn0010015,CanA1,3R,31039374,31046821,7447
FBgn0016123,Alp4,3R,31048929,31052540,3611
FBgn0024288,Sox100B,3R,31065253,31083407,18154
FBgn0039820,CG15554,3R,31126149,31127335,1186
FBgn0039821,Ktch,3R,31127965,31130666,2701
FBgn0039818,Mayo,3R,31106362,31109191,2829
FBgn0039816,CG11317,3R,31090712,31097321,6609
FBgn0002413,dco,3R,31054085,31061210,7125
FBgn0010808,Chchd3,3R,31052616,31053915,1299
FBgn0004573,5-HT7,3R,30968236,31016875,48639
FBgn0051008,CG31008,3R,30989478,30990006,528
FBgn0039811,CG15550,3R,30936589,30937102,513
FBgn0013973,Gycbeta100B,3R,31134392,31178278,43886
FBgn0039827,CG1544,3R,31196916,31203722,6806
FBgn0039828,CG1542,3R,31213458,31214784,1326
FBgn0039831,CG12054,3R,31220702,31231259,10557
FBgn0039835,mRpL32,3R,31252872,31253686,814
FBgn0040629,CAH5,3R,31262598,31263878,1280
FBgn0039839,ppk24,3R,31265730,31268511,2781
FBgn0039836,CG1750,3R,31253659,31254900,1241
FBgn0051005,qless,3R,31236035,31252608,16573
FBgn0039830,ATPsynC,3R,31216145,31219630,3485
FBgn0046696,RNaseP:RNA,3R,31217364,31217662,298
FBgn0039829,CG15561,3R,31214776,31215942,1166
FBgn0061476,Zwilch,3R,31210966,31213376,2410
FBgn0051004,mesh,3R,31178389,31195762,17373
FBgn0046332,gskt,3R,31372427,31374198,1771
FBgn0039844,CG1607,3R,31382109,31391893,9784
FBgn0019990,Gcn2,3R,31395660,31402013,6353
FBgn0039850,CG11333,3R,31463301,31464134,833
FBgn0039851,mey,3R,31499235,31506992,7757
FBgn0039852,nyo,3R,31543032,31566165,23133
FBgn0028968,gammaCOP,3R,31572143,31575707,3564
FBgn0003268,rod,3R,31580951,31588244,7293
FBgn0039854,CG1635,3R,31588673,31590392,1719
FBgn0039855,CG1638,3R,31590581,31592316,1735
FBgn0039856,CG1774,3R,31592803,31594719,1916
FBgn0039858,CycG,3R,31596642,31612664,16022
FBgn0039857,RpL6,3R,31594792,31596204,1412
FBgn0043900,pygo,3R,31575835,31580699,4864
FBgn0039849,CG11334,3R,31459822,31463037,3215
FBgn0039848,Loxl1,3R,31458380,31459869,1489
FBgn0039846,PNPase,3R,31401560,31405452,3892
FBgn0051204,CG31204,3R,31391894,31393527,1633
FBgn0039860,CG1792,3R,31616303,31617837,1534
FBgn0039861,pasha,3R,31617977,31622217,4240
FBgn0039862,kek6,3R,31622136,31664646,42510
FBgn0039863,Zmynd8,3R,31669465,31677971,8506
FBgn0003870,ttk,3R,31713867,31735392,21525
FBgn0039868,CG11563,3R,31737035,31737999,964
FBgn0000557,eEF1alpha2,3R,31738468,31743306,4838
FBgn0039869,Tbca,3R,31743490,31744248,758
FBgn0039870,CG1896,3R,31744282,31745178,896
FBgn0022349,CG1910,3R,31747643,31751894,4251
FBgn0039875,sip3,3R,31772219,31775163,2944
FBgn0005632,faf,3R,31777020,31790681,13661
FBgn0027620,Acf,3R,31793981,31799799,5818
FBgn0039879,Ir100a,3R,31800963,31802774,1811
FBgn0039881,CG1971,3R,31805468,31806769,1301
FBgn0039882,Rift,3R,31806867,31810186,3319
FBgn0039877,Mccc1,3R,31790592,31793907,3315
FBgn0039876,CG2126,3R,31775049,31776652,1603
FBgn0003065,CG2150,3R,31763304,31764772,1468
FBgn0000150,awd,3R,31745172,31746077,905
FBgn0039867,CstF50,3R,31735503,31736963,1460
FBgn0039864,CG11550,3R,31678147,31679880,1733
FBgn0039859,Mnat9,3R,31615284,31616160,876
FBgn0039883,RhoGAP100F,3R,31812609,31846570,33961
FBgn0039886,CG2003,3R,31978121,31990909,12788
FBgn0002780,mod,3R,32052060,32054974,2914
FBgn0002645,Map205,3R,32055279,32068441,13162
FBgn0040206,krz,3R,32045314,32051993,6679
FBgn0011224,heph,3R,31846987,32015520,168533
FBgn0032956,Cul2,2L,21658735,21663698,4963
FBgn0051619,nolo,2L,21684106,21729051,44945
FBgn0032961,CG1416,2L,21758010,21761000,2990
FBgn0003866,tsh,2L,21828593,21837011,8418
FBgn0051612,CG31612,2L,21762314,21795447,33133
FBgn0032964,CG11630,2L,21782046,21784065,2019
FBgn0000559,eEF2,2L,21677913,21682164,4251
FBgn0032973,CG6675,2L,22108964,22110449,1485
FBgn0025674,CycK,2L,22124285,22130142,5857
FBgn0040519,CG15219,2L,22104891,22105512,621
FBgn0051601,CG31601,2L,22040727,22043877,3150
FBgn0032969,CG2528,2L,21974749,21992933,18184
FBgn0032981,CG3635,2L,22175415,22183991,8576
FBgn0042701,CR12628,2L,22226152,22226771,619
FBgn0032986,Nubpl,2L,22239916,22246988,7072
FBgn0032988,Tif-IA,2L,22249876,22258260,8384
FBgn0039972,Marf1,2L,22308755,22368796,60041
FBgn0032987,RpL21,2L,22247111,22247875,764
FBgn0032979,Clamp,2L,22165720,22169143,3423
FBgn0033050,Pngl,2R,6017739,6020695,2956
FBgn0033055,Tbce,2R,6042532,6044964,2432
FBgn0033058,CCHa2-R,2R,6050949,6068680,17731
FBgn0033060,CG7849,2R,6076910,6078088,1178
FBgn0033063,CG14589,2R,6137303,6138411,1108
FBgn0033065,Cyp6w1,2R,6173684,6176195,2511
FBgn0040502,CG8343,2R,6179726,6180356,630
FBgn0033069,eIF3f2,2R,6200853,6201956,1103
FBgn0050431,CG30431,2R,6202725,6205224,2499
FBgn0033074,tomboy40,2R,6225634,6226884,1250
FBgn0021847,Ttc7,2R,6209782,6214122,4340
FBgn0033072,CG17994,2R,6207219,6209468,2249
FBgn0050432,CG30432,2R,6197387,6198266,879
FBgn0033067,CG11211,2R,6180926,6181626,700
FBgn0011890,tRNA:Lys-CTT-1-5,2R,6171496,6171568,72
FBgn0000546,EcR,2R,6087873,6169087,81214
FBgn0011891,tRNA:Lys-CTT-1-1,2R,6142372,6142444,72
FBgn0033062,Ars2,2R,6080828,6085625,4797
FBgn0033061,SmydA-5,2R,6078641,6080572,1931
FBgn0033054,CG14591,2R,6036557,6040647,4090
FBgn0033052,SCAP,2R,6026273,6036388,10115
FBgn0033051,Strica,2R,6020311,6023144,2833
FBgn0000043,Act42A,2R,6013910,6015689,1779
FBgn0033048,CG7881,2R,5960275,5966856,6581
FBgn0027507,CG1344,2R,5653676,5656778,3102
FBgn0033031,CG8245,2R,5668383,5669986,1603
FBgn0033032,kune,2R,5671741,5672800,1059
FBgn0022288,l(2)09851,2R,5754517,5756327,1810
FBgn0033041,Or42a,2R,5791441,5792967,1526
FBgn0025693,ZnT41F,2R,5774776,5782858,8082
FBgn0033038,CG7791,2R,5758065,5760407,2342
FBgn0033033,scaf,2R,5676750,5691723,14973
FBgn0033029,Not3,2R,5656406,5663222,6816
FBgn0050438,Ugt50B3,2R,5496674,5549543,52869
FBgn0039970,CG17508,2R,5608635,5611586,2951
FBgn0033028,hrm,2R,5640915,5652815,11900
FBgn0039969,Fis1,2R,5603587,5604834,1247
FBgn0033027,TpnC4,2R,5503437,5507866,4429
FBgn0050440,CG30440,2R,5468319,5495861,27542
FBgn0042085,Bap170,2R,6636512,6642358,5846
FBgn0029131,Debcl,2R,6648654,6652842,4188
FBgn0050443,Opbp,2R,6653217,6655267,2050
FBgn0013732,sced,2R,6657326,6660624,3298
FBgn0033085,CG15908,2R,6668150,6668738,588
FBgn0033086,CG9410,2R,6669024,6670076,1052
FBgn0033088,PGAP3,2R,6673604,6675061,1457
FBgn0033092,Rpp25,2R,6675822,6693162,17340
FBgn0033090,CG15909,2R,6683186,6684710,1524
FBgn0033093,CG3270,2R,6693430,6695187,1757
FBgn0014009,Rab2,2R,6696739,6699469,2730
FBgn0028579,phtf,2R,6741899,6746141,4242
FBgn0042083,Mccc2,2R,6746381,6748954,2573
FBgn0027066,Eb1,2R,6749227,6756300,7073
FBgn0000473,Cyp6a2,2R,6779749,6781491,1742
FBgn0033101,CG9436,2R,6757601,6758903,1302
FBgn0033100,CG3420,2R,6756296,6757209,913
FBgn0010482,hlk,2R,6721101,6740672,19571
FBgn0033095,chk,2R,6699695,6715892,16197
FBgn0050446,Tdc2,2R,6684745,6689974,5229
FBgn0033089,CG17266,2R,6675028,6676001,973
FBgn0033087,Hsepi,2R,6670154,6673372,3218
FBgn0033081,geminin,2R,6655463,6656594,1131
FBgn0033079,Fmo-2,2R,6642418,6645098,2680
FBgn0026761,Trap1,2R,6633647,6636262,2615
FBgn0014028,SdhB,2R,6807626,6809172,1546
FBgn0033108,CG15236,2R,6828356,6838360,10004
FBgn0033113,Spn42Dc,2R,6880995,6883407,2412
FBgn0028988,Spn42Dd,2R,6883280,6884873,1593
FBgn0033115,Spn42De,2R,6885552,6888262,2710
FBgn0050158,CG30158,2R,6891760,6922613,30853
FBgn0033117,CG3358,2R,6923366,6924929,1563
FBgn0053348,CheB42a,2R,6949482,6950284,802
FBgn0053349,ppk25,2R,6950385,6952158,1773
FBgn0033122,CG17002,2R,6986043,6988922,2879
FBgn0029508,Tsp42Ea,2R,6992676,7004259,11583
FBgn0042086,Tsp42Eb,2R,6998848,6999848,1000
FBgn0050160,CG30160,2R,7005157,7006136,979
FBgn0033124,Tsp42Ec,2R,7006442,7008622,2180
FBgn0029506,Tsp42Ee,2R,7012254,7018362,6108
FBgn0029507,Tsp42Ed,2R,7009498,7011739,2241
FBgn0022960,vimar,2R,6975285,6985712,10427
FBgn0050156,CG30156,2R,6981446,6985712,4266
FBgn0033121,Cyp6u1,2R,6971996,6975026,3030
FBgn0050157,Ufsp1,2R,6974038,6975133,1095
FBgn0066292,CheB42c,2R,6944614,6971637,27023
FBgn0066293,CheB42b,2R,6943096,6943995,899
FBgn0033112,Spn42Db,2R,6879285,6880770,1485
FBgn0033110,CG9447,2R,6872996,6875819,2823
FBgn0040674,CG9445,2R,6838074,6839055,981
FBgn0022224,ubl,2R,6810011,6810530,519
FBgn0034511,GNBP-like3,2R,20526311,20526825,514
FBgn0050154,CG30154,2R,20533359,20533934,575
FBgn0034512,Bbd,2R,20534245,20535835,1590
FBgn0034513,CG13423,2R,20536578,20538264,1686
FBgn0034520,lms,2R,20556877,20559953,3076
FBgn0034527,CG9945,2R,20618503,20621081,2578
FBgn0034529,FAM21,2R,20623547,20628315,4768
FBgn0034532,CG13436,2R,20636392,20638423,2031
FBgn0034534,maf-S,2R,20640976,20641668,692
FBgn0034535,CG11110,2R,20641742,20642558,816
FBgn0034537,DMAP1,2R,20644036,20645865,1829
FBgn0034540,Lrt,2R,20646360,20661070,14710
FBgn0034541,CG13437,2R,20661585,20662595,1010
FBgn0034543,galla-1,2R,20670636,20673495,2859
FBgn0034546,CG13442,2R,20727829,20730610,2781
FBgn0000615,exu,2R,20667427,20671083,3656
FBgn0034542,Fem-1,2R,20662474,20667306,4832
FBgn0034539,CG11159,2R,20655756,20656609,853
FBgn0034538,CG16799,2R,20652557,20655096,2539
FBgn0034530,Rcd6,2R,20628186,20633506,5320
FBgn0034528,CG11180,2R,20620914,20623429,2515
FBgn0050147,Hil,2R,20606881,20618217,11336
FBgn0034523,Nnf1a,2R,20586222,20587238,1016
FBgn0028622,qsm,2R,20563034,20583591,20557
FBgn0034521,Mgat1,2R,20559156,20562331,3175
FBgn0034517,Cpr57A,2R,20548368,20550117,1749
FBgn0043536,Obp57d,2R,20548368,20550117,1749
FBgn0050145,Obp57e,2R,20547816,20548291,475
FBgn0050148,CG30148,2R,20546595,20547658,1063
FBgn0034515,CG13428,2R,20539512,20540448,936
FBgn0050151,CG30151,2R,20528503,20529464,961
FBgn0034491,Hsl,2R,20257650,20261726,4076
FBgn0010411,RpS18,2R,20263979,20264848,869
FBgn0034493,CG8908,2R,20264920,20270994,6074
FBgn0034502,CG13871,2R,20317323,20319039,1716
FBgn0034504,CG8929,2R,20327270,20330721,3451
FBgn0034505,CG16739,2R,20341993,20342749,756
FBgn0034506,CG13870,2R,20343845,20346018,2173
FBgn0034509,Obp57c,2R,20503584,20504202,618
FBgn0043534,Obp57b,2R,20504251,20505136,885
FBgn0043535,Obp57a,2R,20505150,20505758,608
FBgn0034503,MED8,2R,20325844,20326806,962
FBgn0034501,CG13868,2R,20308777,20316917,8140
FBgn0034500,CG11200,2R,20304517,20308671,4154
FBgn0034499,Cpr56F,2R,20288371,20291945,3574
FBgn0034498,CG16868,2R,20281629,20287094,5465
FBgn0034497,Mpcp1,2R,20279066,20281127,2061
FBgn0034494,CG10444,2R,20271653,20274499,2846
FBgn0005655,PCNA,2R,20261754,20262883,1129
FBgn0034481,CG11041,2R,20146118,20146824,706
FBgn0034484,CG11044,2R,20231829,20234927,3098
FBgn0034485,CG11099,2R,20236235,20239200,2965
FBgn0034487,Efhc1.2,2R,20239936,20242873,2937
FBgn0025720,Ate1,2R,20254966,20257390,2424
FBgn0034490,CG9864,2R,20248130,20254670,6540
FBgn0034488,Hacl,2R,20242752,20245388,2636
FBgn0034486,CG13869,2R,20238495,20239429,934
FBgn0034483,CG16894,2R,20211585,20212619,1034
FBgn0034480,CG16898,2R,20003620,20005003,1383
FBgn0034471,Obp56e,2R,19712345,19712932,587
FBgn0043533,Obp56f,2R,19713395,19713976,581
FBgn0034472,CG8517,2R,19714076,19714868,792
FBgn0034475,Obp56h,2R,19815554,19816204,650
FBgn0034476,Toll-7,2R,19826578,19832973,6395
FBgn0034477,CG13872,2R,19878836,19880920,2084
FBgn0034474,Obp56g,2R,19783484,19784043,559
FBgn0002716,mei-W68,2R,19456170,19459523,3353
FBgn0026378,Rep,2R,19492087,19494125,2038
FBgn0034454,CG15120,2R,19497752,19500372,2620
FBgn0034455,CG11007,2R,19503068,19504594,1526
FBgn0034456,Ir56b,2R,19508167,19509653,1486
FBgn0034459,TTLL6A,2R,19593790,19596866,3076
FBgn0034460,CG18367,2R,19636660,19637400,740
FBgn0034464,CG11018,2R,19662436,19663738,1302
FBgn0028372,Kpc2,2R,19670618,19673477,2859
FBgn0034468,Obp56a,2R,19697723,19698508,785
FBgn0034470,Obp56d,2R,19702924,19703915,991
FBgn0046879,Obp56c,2R,19699995,19701124,1129
FBgn0046880,Obp56b,2R,19698714,19699346,632
FBgn0034467,CG15128,2R,19685614,19688078,2464
FBgn0015949,hrg,2R,19663919,19669832,5913
FBgn0034458,Ir56d,2R,19511673,19513571,1898
FBgn0040732,CG16926,2R,19500295,19501418,1123
FBgn0034452,Oseg6,2R,19487046,19491846,4800
FBgn0034451,Tbcb,2R,19485494,19486837,1343
FBgn0034422,CG7137,2R,19227344,19228613,1269
FBgn0010434,cora,2R,19229063,19243751,14688
FBgn0004003,wbl,2R,19249395,19250917,1522
FBgn0003254,rib,2R,19270078,19281396,11318
FBgn0013954,Fkbp12,2R,19290109,19290962,853
FBgn0034432,Acadvl,2R,19305172,19307445,2273
FBgn0034435,fest,2R,19341809,19345754,3945
FBgn0034436,CG11961,2R,19357532,19363124,5592
FBgn0034437,CG10051,2R,19363641,19367294,3653
FBgn0034439,CG10062,2R,19375313,19380174,4861
FBgn0034440,CG10073,2R,19380543,19384965,4422
FBgn0034442,CG11257,2R,19390128,19391900,1772
FBgn0012051,CalpA,2R,19425113,19430564,5451
FBgn0040273,Spt5,2R,19437483,19441898,4415
FBgn0013325,RpL11,2R,19442342,19443825,1483
FBgn0034446,Arl6,2R,19444179,19445058,879
FBgn0034447,CG7744,2R,19452504,19455527,3023
FBgn0020440,Fak,2R,19430659,19437259,6600
FBgn0034443,cer,2R,19396215,19396772,557
FBgn0034438,CG9416,2R,19367248,19373702,6454
FBgn0034433,EndoB,2R,19307447,19310665,3218
FBgn0034430,mip40,2R,19291105,19292196,1091
FBgn0034425,CG11906,2R,19281418,19283961,2543
FBgn0034408,sano,2R,18878391,18959500,81109
FBgn0004168,5-HT1A,2R,19067155,19121958,54803
FBgn0027535,botv,2R,19129589,19133706,4117
FBgn0034419,CG15111,2R,19137372,19141034,3662
FBgn0034418,CG15118,2R,19133727,19137169,3442
FBgn0034413,CG15115,2R,19035492,19036387,895
FBgn0041702,CG15107,2R,18971309,18972537,1228
FBgn0014269,prod,2R,18969404,18971133,1729
FBgn0028669,Vha100-3,2R,18908961,18911895,2934
FBgn0034377,CG15071,2R,18696585,18697345,760
FBgn0034379,CG15073,2R,18705977,18708226,2249
FBgn0053147,Hs3st-A,2R,18718114,18754675,36561
FBgn0034387,Cyp12b2,2R,18754995,18757083,2088
FBgn0034391,CG15080,2R,18783299,18794594,11295
FBgn0010551,Phb2,2R,18819467,18822250,2783
FBgn0034397,CG15082,2R,18830331,18833241,2910
FBgn0034399,CG15083,2R,18835263,18836842,1579
FBgn0034402,CG15084,2R,18850844,18851963,1119
FBgn0004240,DptA,2R,18865765,18866260,495
FBgn0034407,DptB,2R,18867391,18867895,504
FBgn0034406,Jheh3,2R,18860375,18862078,1703
FBgn0010053,Jheh1,2R,18853434,18855087,1653
FBgn0034403,CG18190,2R,18851907,18853043,1136
FBgn0034401,MetRS,2R,18846858,18850599,3741
FBgn0034400,CG15099,2R,18836821,18846619,9798
FBgn0034398,CG15098,2R,18833372,18834775,1403
FBgn0034396,CG15097,2R,18822188,18829699,7511
FBgn0034394,CG15096,2R,18808356,18815019,6663
FBgn0010651,MFS14,2R,18796975,18803727,6752
FBgn0034392,MFS15,2R,18794618,18796678,2060
FBgn0034390,CG15093,2R,18775669,18776978,1309
FBgn0034382,CG18609,2R,18742517,18743626,1109
FBgn0050121,lncRNA:CR30121,2R,18739131,18741658,2527
FBgn0034381,List,2R,18727817,18730281,2464
FBgn0034380,Vps51,2R,18708152,18710865,2713
FBgn0023214,edl,2R,18667527,18673536,6009
FBgn0053136,CG33136,2R,18664449,18665792,1343
FBgn0034372,Gint3,2R,18658418,18661548,3130
FBgn0034371,Ntan1,2R,18640862,18658222,17360
FBgn0050122,CG30122,2R,18632328,18639270,6942
FBgn0034368,zda,2R,18629594,18632045,2451
FBgn0034329,BomS1,2R,18383949,18384378,429
FBgn0034330,BomS4,2R,18384567,18384911,344
FBgn0025583,BomS2,2R,18386602,18387030,428
FBgn0040736,BomS3,2R,18387895,18388734,839
FBgn0040735,BomT2,2R,18388995,18389443,448
FBgn0040734,BomS5,2R,18389959,18390242,283
FBgn0064237,Idgf5,2R,18393666,18395282,1616
FBgn0034335,GstE1,2R,18398393,18399223,830
FBgn0063498,GstE2,2R,18399486,18400375,889
FBgn0063497,GstE3,2R,18400713,18401467,754
FBgn0063496,GstE4,2R,18403248,18404086,838
FBgn0063495,GstE5,2R,18404605,18405338,733
FBgn0063494,GstE6,2R,18406011,18406761,750
FBgn0063493,GstE7,2R,18406924,18407688,764
FBgn0063492,GstE8,2R,18407834,18408955,1121
FBgn0063491,GstE9,2R,18409048,18409835,787
FBgn0027835,Dp1,2R,18412027,18421124,9097
FBgn0034345,CG5174,2R,18421413,18426221,4808
FBgn0034346,PIG-O,2R,18426421,18430333,3912
FBgn0034350,Lamtor2,2R,18446548,18449420,2872
FBgn0050120,CG30120,2R,18446548,18449420,2872
FBgn0034351,rswl,2R,18451284,18452736,1452
FBgn0034354,GstE11,2R,18503608,18505025,1417
FBgn0034356,Pepck2,2R,18527430,18535749,8319
FBgn0003067,Pepck1,2R,18536767,18539416,2649
FBgn0034360,CG10927,2R,18613090,18614255,1165
FBgn0034362,CG5323,2R,18615060,18615999,939
FBgn0034363,CG5327,2R,18615988,18618317,2329
FBgn0034365,CG5335,2R,18621541,18622986,1445
FBgn0000566,Cth,2R,18627918,18629395,1477
FBgn0034366,Atg7,2R,18620466,18625044,4578
FBgn0034364,CG5493,2R,18616692,18619328,2636
FBgn0034361,mRpS28,2R,18614210,18615018,808
FBgn0050115,GEFmeso,2R,18554119,18611777,57658
FBgn0028496,CG30116,2R,18456602,18498026,41424
FBgn0034352,Dnaaf3,2R,18452737,18454462,1725
FBgn0013983,imd,2R,18409796,18413599,3803
FBgn0063499,GstE10,2R,18396638,18398519,1881
FBgn0040733,BomS6,2R,18390353,18390629,276
FBgn0034331,BomBc2,2R,18384824,18385589,765
FBgn0034328,BomBc1,2R,18382704,18383235,531
FBgn0034300,CG5098,2R,18094940,18101031,6091
FBgn0028983,Spn55B,2R,18126347,18128210,1863
FBgn0040465,Dlip3,2R,18128494,18130246,1752
FBgn0003044,Pcl,2R,18135426,18139990,4564
FBgn0000057,adp,2R,18151704,18154060,2356
FBgn0034307,CG10914,2R,18158257,18160310,2053
FBgn0034308,Naus,2R,18160720,18164746,4026
FBgn0034312,CG10916,2R,18173669,18175725,2056
FBgn0000658,fj,2R,18232761,18236311,3550
FBgn0034321,CG14502,2R,18288696,18294712,6016
FBgn0034322,CG18536,2R,18294759,18295658,899
FBgn0034326,CG18540,2R,18299317,18300072,755
FBgn0034327,CG14505,2R,18302945,18303977,1032
FBgn0034313,CG5726,2R,18175255,18180197,4942
FBgn0027836,Dgp-1,2R,18168413,18172607,4194
FBgn0034310,Nup75,2R,18164694,18167140,2446
FBgn0022238,lolal,2R,18154095,18158192,4097
FBgn0034304,CG5742,2R,18148096,18151410,3314
FBgn0062440,EMRE,2R,18147297,18147997,700
FBgn0001222,Hsf,2R,18130303,18134634,4331
FBgn0003520,stau,2R,18117896,18125779,7883
FBgn0034301,CG5756,2R,18101061,18108389,7328
FBgn0034299,CG5757,2R,18093723,18094900,1177
FBgn0041585,Orai,2R,17843442,17860582,17140
FBgn0015522,olf186-M,2R,17846699,17848444,1745
FBgn0050323,CG30323,2R,17853295,17854296,1001
FBgn0034281,CG14490,2R,17860760,17861591,831
FBgn0011589,Elk,2R,17873939,17926695,52756
FBgn0034295,CG10911,2R,18052550,18054066,1516
FBgn0034293,CG14495,2R,18048804,18049922,1118
FBgn0034291,CG5770,2R,18044046,18045073,1027
FBgn0034290,CG5773,2R,18042296,18043744,1448
FBgn0034282,Mapmodulin,2R,17866178,17872015,5837
FBgn0034242,CG14480,2R,17564340,17565852,1512
FBgn0040294,POSH,2R,17568732,17572322,3590
FBgn0016701,Rab4,2R,17573462,17574979,1517
FBgn0029079,icln,2R,17590964,17591881,917
FBgn0029006,Smurf,2R,17592791,17604461,11670
FBgn0034251,ND-51L1,2R,17595267,17597409,2142
FBgn0034258,eIF3c,2R,17665678,17669275,3597
FBgn0050108,CG30108,2R,17669395,17670000,605
FBgn0050109,CG30109,2R,17670082,17670748,666
FBgn0034261,HPS4,2R,17683574,17690822,7248
FBgn0045800,Uhg1,2R,17699097,17703344,4247
FBgn0034263,CG10934,2R,17722339,17723381,1042
FBgn0034264,Dlish,2R,17723309,17725056,1747
FBgn0034266,CG4975,2R,17726914,17732987,6073
FBgn0034267,CG4984,2R,17726914,17732987,6073
FBgn0034271,Vps50,2R,17739901,17743969,4068
FBgn0003545,sub,2R,17745500,17748078,2578
FBgn0034270,PIG-A,2R,17737622,17739685,2063
FBgn0034269,Hyccin,2R,17734419,17737269,2850
FBgn0034265,Snx16,2R,17725030,17726847,1817
FBgn0028494,CG6424,2R,17703335,17719346,16011
FBgn0027872,rdgBbeta,2R,17695776,17698362,2586
FBgn0034262,swi2,2R,17690275,17695353,5078
FBgn0016059,Sema1b,2R,17672839,17683499,10660
FBgn0034259,P32,2R,17671309,17672640,1331
FBgn0050106,CCHa1-R,2R,17646848,17665068,18220
FBgn0034253,CG10936,2R,17604951,17639138,34187
FBgn0034255,Oxp,2R,17633797,17634167,370
FBgn0004400,rhi,2R,17628491,17633516,5025
FBgn0050105,CG30105,2R,17591804,17592509,705
FBgn0034249,RhoGAP54D,2R,17586425,17590884,4459
FBgn0034248,CG14483,2R,17585195,17586294,1099
FBgn0034247,CG6484,2R,17582007,17584012,2005
FBgn0034246,Dcr-2,2R,17574979,17581525,6546
FBgn0034245,UQCR-6.4,2R,17572096,17572784,688
FBgn0034243,Ns2,2R,17565779,17568456,2677
FBgn0010620,CG10939,2R,17394593,17405171,10578
FBgn0016697,Prosalpha5,2R,17412767,17413769,1002
FBgn0022029,l(2)k01209,2R,17420407,17425679,5272
FBgn0034215,Mtap,2R,17427795,17429315,1520
FBgn0034217,Lhr,2R,17431032,17432219,1187
FBgn0034218,CG18467,2R,17440297,17442483,2186
FBgn0034221,CG10764,2R,17453399,17455729,2330
FBgn0024196,robl,2R,17456472,17457129,657
FBgn0028953,CG14478,2R,17457663,17465795,8132
FBgn0022987,qkr54B,2R,17469624,17475129,5505
FBgn0034225,veil,2R,17478158,17482118,3960
FBgn0050104,NT5E-2,2R,17485002,17493169,8167
FBgn0050103,CG30103,2R,17493695,17495998,2303
FBgn0034229,CtsK2,2R,17511513,17513855,2342
FBgn0034230,CG4853,2R,17514217,17517445,3228
FBgn0034232,CG4866,2R,17518223,17519027,804
FBgn0034237,eIF3b,2R,17536213,17539142,2929
FBgn0028382,cyp33,2R,17545222,17546400,1178
FBgn0034240,MESR4,2R,17547769,17556289,8520
FBgn0010409,RpL18A,2R,17546406,17547462,1056
FBgn0034231,APC10,2R,17517261,17518186,925
FBgn0034223,Tes,2R,17465879,17469177,3298
FBgn0028956,mthl3,2R,17448533,17452598,4065
FBgn0034219,mthl4,2R,17445185,17447483,2298
FBgn0027506,EDTP,2R,17432173,17444938,12765
FBgn0025716,Bap55,2R,17429353,17430963,1610
FBgn0034214,CG6550,2R,17425670,17427511,1841
FBgn0050101,Vajk4,2R,17408258,17410204,1946
FBgn0034210,Camp,2R,17405304,17407427,2123
FBgn0034179,CG6805,2R,17005451,17007501,2050
FBgn0023172,RhoGEF2,2R,17027190,17044653,17463
FBgn0034182,SmydA-7,2R,17044743,17046768,2025
FBgn0034184,CG9646,2R,17048875,17053855,4980
FBgn0026721,fat-spondin,2R,17054002,17059299,5297
FBgn0034187,Mov10,2R,17062775,17066546,3771
FBgn0034191,CG6984,2R,17091984,17093070,1086
FBgn0034194,CG15611,2R,17108844,17114360,5516
FBgn0000078,Amy-d,2R,17124764,17126369,1605
FBgn0034197,Cda9,2R,17128480,17130334,1854
FBgn0034198,CG11400,2R,17134129,17135345,1216
FBgn0034199,Gbp1,2R,17136451,17136903,452
FBgn0034200,Gbp2,2R,17137240,17139595,2355
FBgn0034201,CG17290,2R,17154589,17157125,2536
FBgn0034205,CG10950,2R,17195203,17197159,1956
FBgn0046294,CG12699,2R,17246530,17247383,853
FBgn0023458,Rbcn-3A,X,6240745,6255487,14742
FBgn0029877,CG17717,X,6589290,6590646,1356
FBgn0029878,Pat1,X,6590776,6596954,6178
FBgn0029879,APC7,X,6597088,6599699,2611
FBgn0029881,pigs,X,6600062,6653015,52953
FBgn0029880,CG14443,X,6633959,6636169,2210
FBgn0028360,Cdc7,X,6654541,6659709,5168
FBgn0062413,Ctr1A,X,6661647,6668258,6611
FBgn0025815,Mcm6,X,6674387,6677176,2789
FBgn0029895,CG14441,X,6699508,6719389,19881
FBgn0029898,CG14439,X,6747544,6755752,8208
FBgn0029502,Coq7,X,6771225,6773039,1814
FBgn0029903,pod1,X,6803684,6813830,10146
FBgn0029906,xit,X,6821016,6822840,1824
FBgn0029907,Atx-1,X,6823204,6824203,999
FBgn0029905,Nf-YC,X,6818178,6820919,2741
FBgn0003390,shf,X,6771463,6779659,8196
FBgn0029897,RpL17,X,6741537,6744238,2701
FBgn0029896,CG3168,X,6720004,6739986,19982
FBgn0029894,CG14440,X,6695866,6698567,2701
FBgn0029893,CG14442,X,6689296,6695007,5711
FBgn0029892,CG3184,X,6687596,6688774,1178
FBgn0029887,CG3198,X,6668539,6673973,5434
FBgn0029885,CG3224,X,6660552,6661462,910
FBgn0029882,CG3226,X,6653113,6654248,1135
FBgn0029912,Tmf,X,6844341,6847847,3506
FBgn0029914,CG4558,X,6849770,6851884,2114
FBgn0029920,CR4575,X,6950510,6951266,756
FBgn0052733,CR32733,X,6952336,6952809,473
FBgn0029922,CG14431,X,6908277,6968829,60552
FBgn0029924,CG4586,X,6969918,6972265,2347
FBgn0027108,Inx2,X,6998672,7004151,5479
FBgn0052736,sloth1,X,7011357,7012137,780
FBgn0029929,CG4593,X,7013887,7015009,1122
FBgn0029932,CG4607,X,7069413,7072689,3276
FBgn0029937,CG8300,X,7104885,7106345,1460
FBgn0027342,fz4,X,7106272,7110321,4049
FBgn0029936,CG4617,X,7102555,7104491,1936
FBgn0029935,CG4615,X,7098578,7102300,3722
FBgn0029930,CG12541,X,7021608,7066052,44444
FBgn0029928,CG3032,X,7012239,7013881,1642
FBgn0000330,cm,X,7009006,7011145,2139
FBgn0027106,Inx7,X,6991612,6993612,2000
FBgn0004646,ogre,X,6973620,6991318,17698
FBgn0029925,CG3040,X,6972324,6973393,1069
FBgn0052732,Setd3,X,6958032,6968750,10718
FBgn0029915,CG14434,X,6851909,6867194,15285
FBgn0029913,Cht11,X,6847877,6849517,1640
FBgn0029911,CG14435,X,6838174,6843921,5747
FBgn0029939,Cph,X,7137723,7241932,104209
FBgn0029942,CG2059,X,7286358,7288117,1759
FBgn0029944,Dok,X,7324214,7328806,4592
FBgn0029945,Acsf3,X,7329046,7331255,2209
FBgn0026144,CBP,X,7337352,7342731,5379
FBgn0029947,CG1999,X,7358796,7360058,1262
FBgn0029950,rumpel,X,7418594,7422142,3548
FBgn0040923,CG11368,X,7452209,7452643,434
FBgn0052726,CG32726,X,7425220,7425743,523
FBgn0040922,CG15036,X,7424527,7424842,315
FBgn0029943,Atg5,X,7314622,7323770,9148
FBgn0025549,unc-119,X,7288367,7291298,2931
FBgn0004198,ct,X,7608428,7678859,70431
FBgn0022786,Hira,X,7722119,7725917,3798
FBgn0029957,CG12155,X,7728755,7731729,2974
FBgn0029959,Rab39,X,7734923,7736756,1833
FBgn0016041,Tom40,X,7736893,7739978,3085
FBgn0029961,Ir7a,X,7764982,7766826,1844
FBgn0029958,Pdp,X,7731779,7734651,2872
FBgn0027553,NELF-B,X,7725996,7728361,2365
FBgn0029955,CG15478,X,7712783,7717932,5149
FBgn0029952,CG12689,X,7585303,7586131,828
FBgn0052719,CG32719,X,7508651,7547992,39341
FBgn0029962,CARPA,X,7826197,7842679,16482
FBgn0029966,Ir7c,X,7874394,7876847,2453
FBgn0040087,p115,X,7894031,7896991,2960
FBgn0010292,bys,X,7901880,7903643,1763
FBgn0029975,spidey,X,7908931,7911885,2954
FBgn0029976,snz,X,7912089,7918444,6355
FBgn0004403,RpS14a,X,7933742,7934677,935
FBgn0004404,RpS14b,X,7934898,7935792,894
FBgn0003447,sn,X,7964024,7986601,22577
FBgn0004657,mys,X,8061645,8070237,8592
FBgn0029993,CG1571,X,8075877,8078240,2363
FBgn0040319,Gclc,X,8102181,8116147,13966
FBgn0029997,CG2258,X,8094250,8102095,7845
FBgn0029996,UbcE2H,X,8087544,8094064,6520
FBgn0029995,CG2256,X,8084018,8087213,3195
FBgn0029994,Ldsdh1,X,8078350,8081605,3255
FBgn0029992,Upf2,X,8070244,8075466,5222
FBgn0004656,fs(1)h,X,8037808,8061436,23628
FBgn0029990,CG2233,X,8035741,8037517,1776
FBgn0003656,sws,X,7956820,7968236,11416
FBgn0029986,CG15332,X,7953852,7955990,2138
FBgn0027280,orion,X,7941478,7946908,5430
FBgn0029980,Dhdds,X,7931745,7933351,1606
FBgn0029979,mahe,X,7922158,7931382,9224
FBgn0029977,hdm,X,7918517,7920131,1614
FBgn0029974,dpr14,X,7903704,7908286,4582
FBgn0053222,CR33222,X,7898438,7901302,2864
FBgn0029971,ND-MNLL,X,7893053,7893798,745
FBgn0029970,Nek2,X,7889066,7891646,2580
FBgn0029969,Acat1,X,7887130,7888785,1655
FBgn0029999,CG1575,X,8117012,8119130,2118
FBgn0030003,CG2116,X,8129812,8131783,1971
FBgn0030004,CG10958,X,8132285,8134967,2682
FBgn0030005,CG2120,X,8135824,8137046,1222
FBgn0030008,CG2129,X,8145839,8147855,2016
FBgn0030010,CG10959,X,8148783,8150686,1903
FBgn0030012,CG18262,X,8152948,8154533,1585
FBgn0030013,GIIIspla2,X,8157628,8159348,1720
FBgn0030014,CG15337,X,8160054,8161552,1498
FBgn0030025,CG2147,X,8240684,8241483,799
FBgn0020653,Trxr1,X,8242528,8248033,5505
FBgn0030027,CG1632,X,8252670,8272462,19792
FBgn0030030,CG1636,X,8273412,8276450,3038
FBgn0030033,CG1387,X,8385781,8389504,3723
FBgn0030034,CG10555,X,8398940,8404516,5576
FBgn0030035,PIG-T,X,8404535,8407263,2728
FBgn0040928,CR15345,X,8397157,8398298,1141
FBgn0015519,nAChRalpha3,X,8276200,8367169,90969
FBgn0030029,CG15343,X,8272324,8273806,1482
FBgn0030028,Corp,X,8269898,8271409,1511
FBgn0017566,ND-75,X,8248651,8251687,3036
FBgn0030026,sni,X,8241501,8244016,2515
FBgn0030017,CG2278,X,8165833,8170266,4433
FBgn0030016,Or7a,X,8164266,8165708,1442
FBgn0030011,Gbeta5,X,8150731,8152275,1544
FBgn0030007,alpha-PheRS,X,8143904,8145602,1698
FBgn0030006,CG17982,X,8142550,8143835,1285
FBgn0025800,Smox,X,8137041,8142279,5238
FBgn0030001,cyr,X,8121280,8135713,14433
FBgn0030000,CG2260,X,8119082,8121147,2065
FBgn0030038,CG1440,X,8437057,8441264,4207
FBgn0023506,Es2,X,8461479,8463349,1870
FBgn0014465,Cp7Fb,X,8473837,8476071,2234
FBgn0014466,Cp7Fc,X,8477117,8478320,1203
FBgn0053181,CG33181,X,8489348,8517029,27681
FBgn0030049,Trf4-1,X,8560322,8570159,9837
FBgn0030052,CG12065,X,8574306,8588528,14222
FBgn0030053,CG12081,X,8588811,8590774,1963
FBgn0025864,Crag,X,8592031,8602036,10005
FBgn0030055,Rubicon,X,8677063,8680912,3849
FBgn0030056,CAH3,X,8681252,8688760,7508
FBgn0027864,Ogg1,X,8690327,8691811,1484
FBgn0030058,CG11294,X,8691820,8693620,1800
FBgn0030057,Ppt1,X,8688627,8690227,1600
FBgn0030054,Caf1-180,X,8602137,8606304,4167
FBgn0040929,CG12659,X,8590775,8591729,954
FBgn0030051,spirit,X,8571099,8573593,2494
FBgn0030050,CG12111,X,8570208,8570948,740
FBgn0030048,CG12112,X,8558879,8560192,1313
FBgn0026679,IntS4,X,8555239,8558781,3542
FBgn0024943,PIP82,X,8525387,8529698,4311
FBgn0003023,otu,X,8485008,8489535,4527
FBgn0053223,CG33223,X,8465690,8483885,18195
FBgn0030041,CG12116,X,8467443,8469012,1569
FBgn0014032,Sptr,X,8463296,8464438,1142
FBgn0030040,CG15347,X,8458494,8460898,2404
FBgn0030039,CG12123,X,8441247,8442348,1101
FBgn0030037,Miga,X,8433923,8437820,3897
FBgn0041629,Hexo2,X,8709652,8712478,2826
FBgn0030061,CG1785,X,8714936,8717065,2129
FBgn0030063,CG1789,X,8720520,8721503,983
FBgn0030065,CG12075,X,8838323,8872774,34451
FBgn0030067,Rbm13,X,8901699,8903761,2062
FBgn0030073,CG10962,X,8972908,8974255,1347
FBgn0011586,e(r),X,8904144,8906248,2104
FBgn0030066,Uros1,X,8898554,8900264,1710
FBgn0011661,Moe,X,8873012,8898332,25320
FBgn0026411,Lim1,X,8756539,8805804,49265
FBgn0027330,l(1)G0020,X,8716713,8720277,3564
FBgn0030060,CG2004,X,8712472,8714924,2452
FBgn0030082,HP1b,X,9081063,9082746,1683
FBgn0052707,APC4,X,9082931,9085867,2936
FBgn0052708,CG32708,X,9085932,9086864,932
FBgn0052706,CG32706,X,9087129,9088073,944
FBgn0030085,CG6999,X,9088367,9089314,947
FBgn0030086,CCT2,X,9089513,9092826,3313
FBgn0030088,Arfrp1,X,9107069,9108354,1285
FBgn0030089,AP-1gamma,X,9108691,9117744,9053
FBgn0030091,CG7065,X,9142493,9147894,5401
FBgn0030093,Bap111,X,9149309,9151976,2667
FBgn0040467,Dlip1,X,9158622,9159375,753
FBgn0026206,mei-P26,X,9163255,9189309,26054
FBgn0030099,CG12056,X,9192669,9193620,951
FBgn0030100,CG12106,X,9193898,9195333,1435
FBgn0030103,Obp8a,X,9214876,9215699,823
FBgn0030104,CG15368,X,9215785,9216540,755
FBgn0030105,CG15369,X,9216872,9217466,594
FBgn0030107,CG15370,X,9225437,9226688,1251
FBgn0030108,Gr8a,X,9227137,9228827,1690
FBgn0010269,Dsor1,X,9247342,9250037,2695
FBgn0030114,CG17754,X,9250420,9255953,5533
FBgn0028292,ric8a,X,9256168,9259202,3034
FBgn0030122,Aladin,X,9273413,9275653,2240
FBgn0002576,lz,X,9284649,9303636,18987
FBgn0040234,c12.2,X,9319359,9324458,5099
FBgn0040235,c12.1,X,9317915,9319223,1308
FBgn0040236,c11.1,X,9275318,9283117,7799
FBgn0030121,Cfp1,X,9270434,9272960,2526
FBgn0030120,CG17440,X,9268438,9269925,1487
FBgn0052703,Erk7,X,9261376,9267698,6322
FBgn0000077,amx,X,9245915,9247336,1421
FBgn0052704,Ir8a,X,9232726,9236585,3859
FBgn0030109,CG12121,X,9228796,9232378,3582
FBgn0030102,SmydA-9,X,9206126,9210887,4761
FBgn0030101,CG12118,X,9194750,9196414,1664
FBgn0030096,Zpr1,X,9160124,9162090,1966
FBgn0040931,NdufA3,X,9159514,9160052,538
FBgn0014868,Ost48,X,9156929,9158515,1586
FBgn0030092,fh,X,9148080,9149071,991
FBgn0030090,fend,X,9121973,9135099,13126
FBgn0004856,Bx42,X,9103870,9106604,2734
FBgn0030087,CG7766,X,9093612,9103739,10127
FBgn0030081,CG7246,X,9078823,9081057,2234
FBgn0030078,CG10970,X,9069599,9071408,1809
FBgn0030077,CG15365,X,9054698,9067983,13285
FBgn0026149,BCL7-like,X,9356634,9358594,1960
FBgn0030136,RpS28b,X,9554623,9555661,1038
FBgn0001186,Hex-A,X,9585675,9589813,4138
FBgn0030141,Gga,X,9601030,9604280,3250
FBgn0027084,LysRS,X,9606363,9608884,2521
FBgn0052699,LPCAT,X,9571537,9579987,8450
FBgn0052702,Cubn,X,9558665,9571308,12643
FBgn0030137,CG15317,X,9555607,9556544,937
FBgn0028327,l(1)G0320,X,9551140,9553750,2610
FBgn0000233,btd,X,9694186,9697558,3372
FBgn0020378,Sp1,X,9729648,9756369,26721
FBgn0052698,CARPB,X,9783223,9855449,72226
FBgn0026415,Idgf4,X,9927973,9930948,2975
FBgn0030148,CG3106,X,9659095,9662903,3808
FBgn0030164,CG1889,X,9965241,9966959,1718
FBgn0052694,CG32694,X,9989690,10006882,17192
FBgn0004045,Yp1,X,10053811,10055498,1687
FBgn0052693,Gr9a,X,10061627,10062785,1158
FBgn0030174,CG15312,X,10055629,10070868,15239
FBgn0005391,Yp2,X,10050951,10052636,1685
FBgn0030163,CG1791,X,9963453,9964878,1425
FBgn0030177,CG2972,X,10083154,10085050,1896
FBgn0052690,lncRNA:CR32690,X,10204400,10205289,889
FBgn0028342,ATPsyndelta,X,10212970,10217393,4423
FBgn0030189,CG2909,X,10326464,10328946,2482
FBgn0028480,CG17841,X,10368052,10384183,16131
FBgn0030195,CG2898,X,10375374,10376628,1254
FBgn0000711,flw,X,10385960,10409817,23857
FBgn0030206,CG2889,X,10473938,10477201,3263
FBgn0030208,PPP4R2r,X,10478838,10481943,3105
FBgn0052687,CG32687,X,10482028,10487205,5177
FBgn0030207,CG2887,X,10477260,10478493,1233
FBgn0052683,CG32683,X,10410391,10454895,44504
FBgn0030196,Psf3,X,10383353,10385861,2508
FBgn0052681,CG32681,X,10376651,10381352,4701
FBgn0052686,CG32686,X,10371717,10375316,3599
FBgn0052679,CG32679,X,10366402,10367472,1070
FBgn0028331,l(1)G0289,X,10348680,10366273,17593
FBgn0030191,CG15306,X,10330160,10331818,1658
FBgn0011770,Gip,X,10328877,10329872,995
FBgn0040942,CG12643,X,10264233,10265263,1030
FBgn0030187,CG2961,X,10231002,10233080,2078
FBgn0030183,Ypel,X,10205292,10212374,7082
FBgn0030178,Naxe,X,10084914,10086171,1257
FBgn0052685,ZAP3,X,10071858,10082492,10634
FBgn0030217,CG2124,X,10596122,10599169,3047
FBgn0030223,CG2111,X,10657680,10660671,2991
FBgn0052677,X11Lbeta,X,10627737,10710947,83210
FBgn0003204,ras,X,10744502,10749097,4595
FBgn0030228,BTBD9,X,10768537,10772154,3617
FBgn0052672,Atg8a,X,10764878,10768338,3460
FBgn0052675,Tango5,X,10760048,10764413,4365
FBgn0030230,Rph,X,10749077,10757666,8589
FBgn0052676,stx,X,10711163,10744943,33780
FBgn0030222,CG9806,X,10623725,10627112,3387
FBgn0030218,CG1628,X,10598146,10602714,4568
FBgn0001206,Hmr,X,10590920,10595855,4935
FBgn0050295,Ipk1,2R,20870791,20879145,8354
FBgn0034558,Cib2,2R,20879930,20882663,2733
FBgn0020617,Rx,2R,20916753,20937030,20277
FBgn0034564,CG9344,2R,20977056,20977600,544
FBgn0034570,CG10543,2R,20996220,21007740,11520
FBgn0034572,CG9346,2R,21011970,21015628,3658
FBgn0050296,RIC-3,2R,21017784,21024918,7134
FBgn0034576,ND-B14.7,2R,21025078,21026086,1008
FBgn0034577,cpa,2R,21057787,21059883,2096
FBgn0034579,mRpL54,2R,21060789,21061587,798
FBgn0034580,Cht8,2R,21061646,21063212,1566
FBgn0003748,Treh,2R,21074018,21088945,14927
FBgn0034583,CG10527,2R,21070368,21072789,2421
FBgn0050293,Cht12,2R,21063178,21064986,1808
FBgn0034578,CG15653,2R,21059780,21060547,767
FBgn0003391,shg,2R,21049654,21057197,7543
FBgn0034573,Sou,2R,21015594,21017446,1852
FBgn0001133,grau,2R,21009764,21011921,2157
FBgn0050291,CG30291,2R,21007755,21009576,1821
FBgn0034569,dgt3,2R,20992276,20994381,2105
FBgn0034568,CG3216,2R,20986833,20991171,4338
FBgn0034567,CG15651,2R,20983838,20986500,2662
FBgn0008636,hbn,2R,20954668,20960909,6241
FBgn0015524,otp,2R,20883625,20903414,19789
FBgn0040653,Dso1,2R,20868496,20869321,825
FBgn0011674,insc,2R,20821262,20836028,14766
FBgn0016984,sktl,2R,20827282,20836028,8746
FBgn0034588,CG9394,2R,21118394,21120705,2311
FBgn0002736,mago,2R,21128577,21129737,1160
FBgn0021872,Xbp1,2R,21143545,21145750,2205
FBgn0026582,Hmg-2,2R,21146203,21147608,1405
FBgn0034599,hng1,2R,21168930,21170010,1080
FBgn0003162,Pu,2R,21175315,21182608,7293
FBgn0003891,tud,2R,21183322,21192913,9591
FBgn0034602,Lapsyn,2R,21193571,21199431,5860
FBgn0034611,MFS16,2R,21282298,21285679,3381
FBgn0016726,RpL29,2R,21293768,21294404,636
FBgn0020306,dom,2R,21323430,21341847,18417
FBgn0034622,BBS9,2R,21341972,21345608,3636
FBgn0034628,Acox57D-p,2R,21386309,21389276,2967
FBgn0034629,Acox57D-d,2R,21389405,21392439,3034
FBgn0034627,eEFSec,2R,21384552,21386221,1669
FBgn0034626,bisc,2R,21383227,21384391,1164
FBgn0000395,cv-2,2R,21355015,21379464,24449
FBgn0034624,CG17974,2R,21348945,21350578,1633
FBgn0050394,CG30394,2R,21320040,21323320,3280
FBgn0034617,Panx,2R,21310368,21312354,1986
FBgn0034614,CG9752,2R,21294402,21295588,1186
FBgn0050390,Sgf29,2R,21292239,21293646,1407
FBgn0050392,CG30392,2R,21290914,21292181,1267
FBgn0034612,CG10505,2R,21285248,21290343,5095
FBgn0050393,CG30393,2R,21266364,21267579,1215
FBgn0034606,ASPP,2R,21217856,21251150,33294
FBgn0034605,Ugt49C1,2R,21215435,21217779,2344
FBgn0027073,Ugt49B1,2R,21212880,21214972,2092
FBgn0034601,CG4286,2R,21177754,21178636,882
FBgn0034598,Isha,2R,21161713,21168659,6946
FBgn0050389,CG30389,2R,21148265,21160545,12280
FBgn0034595,CG15657,2R,21147478,21148153,675
FBgn0034590,Magi,2R,21129463,21142261,12798
FBgn0020312,Tmtc3,2R,21123735,21128510,4775
FBgn0011824,Gar1,2R,21095958,21097305,1347
FBgn0034585,Rbpn-5,2R,21088386,21091004,2618
FBgn0026369,Sara,2R,21481927,21487107,5180
FBgn0003731,Egfr,2R,21522420,21559977,37557
FBgn0050222,CG30222,2R,21583492,21585368,1876
FBgn0053225,CG33225,2R,21590275,21591584,1309
FBgn0034641,mahj,2R,21625030,21631422,6392
FBgn0034642,CG15674,2R,21632007,21634362,2355
FBgn0034643,CG10321,2R,21634679,21638399,3720
FBgn0034644,Ip6k,2R,21646177,21657935,11758
FBgn0034645,ND-B12,2R,21658078,21658777,699
FBgn0034650,NC2alpha,2R,21670152,21671593,1441
FBgn0050263,stum,2R,21674901,21685000,10099
FBgn0034654,eIF3k,2R,21685283,21686201,918
FBgn0034655,CG10307,2R,21688773,21690253,1480
FBgn0050290,Ppcdc,2R,21691295,21692764,1469
FBgn0010228,HmgZ,2R,21697488,21707861,10373
FBgn0027360,Tim10,2R,21690215,21691139,924
FBgn0050285,BaraC,2R,21687903,21688545,642
FBgn0034649,PIG-M,2R,21667541,21669916,2375
FBgn0034647,pirk,2R,21660967,21662995,2028
FBgn0034646,Rae1,2R,21658770,21660007,1237
FBgn0016641,PTP-ER,2R,21619321,21624446,5125
FBgn0000326,clt,2R,21617061,21619079,2018
FBgn0042180,CG18870,2R,21613845,21616907,3062
FBgn0034639,CG15673,2R,21608393,21613071,4678
FBgn0034638,CG10433,2R,21605676,21608125,2449
FBgn0034636,twz,2R,21560246,21576035,15789
FBgn0050287,CG30287,2R,21536894,21538015,1121
FBgn0050289,CG30289,2R,21520413,21521848,1435
FBgn0034634,CG10494,2R,21516774,21519125,2351
FBgn0034631,TAF1C-like,2R,21498903,21501732,2829
FBgn0010470,Fkbp14,2R,21487167,21497929,10762
FBgn0010415,Sdc,2R,21392402,21481176,88774
FBgn0004362,HmgD,2R,21701458,21716727,15269
FBgn0034657,LBR,2R,21720495,21724055,3560
FBgn0050395,CG30395,2R,21765489,21770196,4707
FBgn0046297,lncRNA:CR9284,2R,21803402,21804338,936
FBgn0034670,CG13488,2R,21951592,21952562,970
FBgn0034674,CG9304,2R,21973122,21976386,3264
FBgn0050401,dany,2R,21985626,21986938,1312
FBgn0034664,CG4377,2R,21835448,21836357,909
FBgn0034662,CG13492,2R,21820662,21831409,10747
FBgn0034660,Loxl2,2R,21789623,21791580,1957
FBgn0050404,Tango11,2R,21716780,21719963,3183
FBgn0050403,CG30403,2R,21709895,21711613,1718
FBgn0067102,GlcT,2R,22075988,22079381,3393
FBgn0034691,Synj,2R,22080176,22085767,5591
FBgn0034694,Plekhm1,2R,22103177,22105963,2786
FBgn0050281,CG30281,2R,22114997,22116189,1192
FBgn0002715,mei-S332,2R,22122101,22124566,2465
FBgn0029147,NtR,2R,22127808,22130184,2376
FBgn0029084,gom,2R,22139935,22141364,1429
FBgn0034704,Fbxo42,2R,22174922,22177428,2506
FBgn0034706,CG11275,2R,22179695,22182642,2947
FBgn0034707,MED16,2R,22183138,22185892,2754
FBgn0034708,Vps35,2R,22185972,22189886,3914
FBgn0025186,ari-2,2R,22212835,22217264,4429
FBgn0020307,dve,2R,22243963,22286469,42506
FBgn0034716,Oatp58Dc,2R,22223681,22228574,4893
FBgn0034712,Alp8,2R,22208464,22210765,2301
FBgn0034709,Swim,2R,22189817,22202671,12854
FBgn0034705,CG11170,2R,22177419,22182879,5460
FBgn0034703,CG3045,2R,22172803,22174691,1888
FBgn0034697,GM130,2R,22124567,22127502,2935
FBgn0034693,flap,2R,22091489,22099534,8045
FBgn0034692,CG13502,2R,22085782,22088727,2945
FBgn0034689,CG2921,2R,22073538,22075308,1770
FBgn0034688,CG11474,2R,22071234,22073443,2209
FBgn0034687,CG11475,2R,22069725,22071286,1561
FBgn0034684,CG13501,2R,22058904,22061517,2613
FBgn0034683,Grl58a,2R,22056467,22057681,1214
FBgn0034717,CG5819,2R,22293400,22296955,3555
FBgn0013272,Gp150,2R,22317662,22329416,11754
FBgn0016053,pgc,2R,22330200,22332813,2613
FBgn0000079,Amy-p,2R,17118636,17120303,1667
FBgn0010591,Sply,2R,17088441,17091958,3517
FBgn0050460,CG30460,2R,17065971,17087633,21662
FBgn0034186,CG8950,2R,17059331,17062634,3303
FBgn0034181,Paip1,2R,17016226,17019522,3296
FBgn0034180,Ehbp1,2R,17007674,17015894,8220
FBgn0034156,CG5348,2R,16766804,16769238,2434
FBgn0011743,Arp53D,2R,16774246,16775676,1430
FBgn0034157,resilin,2R,16779905,16783171,3266
FBgn0034158,RalGPS,2R,16783671,16792472,8801
FBgn0034160,CG5550,2R,16816589,16817577,988
FBgn0028737,eEF1beta,2R,16868222,16869280,1058
FBgn0034162,CG6426,2R,16869402,16871851,2449
FBgn0025827,CG6421,2R,16872250,16872906,656
FBgn0046999,CG6429,2R,16873015,16873755,740
FBgn0034166,CG6472,2R,16880713,16884695,3982
FBgn0004784,inaC,2R,16898535,16901575,3040
FBgn0003091,Pkc53E,2R,16924655,16945126,20471
FBgn0034168,CG15614,2R,16945555,16947231,1676
FBgn0034172,CG6665,2R,16957465,16958927,1462
FBgn0004580,Cbp53E,2R,16973927,16996057,22130
FBgn0034177,AsnRS-m,2R,17001994,17003599,1605
FBgn0026402,NiPp1,2R,17003563,17005149,1586
FBgn0034176,ste24a,2R,17000244,17001941,1697
FBgn0034175,ste24b,2R,16998610,17000126,1516
FBgn0034173,CG9010,2R,16958943,16960195,1252
FBgn0025833,CG8910,2R,16874724,16895652,20928
FBgn0014870,Psi,2R,16861321,16867714,6393
FBgn0025832,Fen1,2R,16854025,16855464,1439
FBgn0026754,Ugt37C1,2R,16843296,16845038,1742
FBgn0010213,Sod2,2R,16772785,16773915,1130
FBgn0015584,Acp53Ea,2R,16749803,16750335,532
FBgn0034153,Acp53C14b,2R,16748815,16749460,645
FBgn0034132,S-Lap8,2R,16491100,16493233,2133
FBgn0011260,Sema2a,2R,16500178,16533459,33281
FBgn0034135,Syn2,2R,16552258,16558486,6228
FBgn0034137,CG4945,2R,16566023,16570120,4097
FBgn0016131,Cdk4,2R,16579470,16585448,5978
FBgn0003274,RpLP2,2R,16586129,16586732,603
FBgn0034144,CG5089,2R,16598748,16600411,1663
FBgn0034145,CG5065,2R,16607654,16624894,17240
FBgn0024232,gprs,2R,16641243,16651125,9882
FBgn0013763,Idgf6,2R,16691022,16693751,2729
FBgn0050463,Pgant9,2R,16673235,16732916,59681
FBgn0024315,Picot,2R,16655323,16667675,12352
FBgn0024319,Nach,2R,16653205,16655046,1841
FBgn0020506,Amyrel,2R,16651095,16652699,1604
FBgn0040505,Alk,2R,16625293,16640011,14718
FBgn0034143,CG8303,2R,16595028,16604373,9345
FBgn0034142,CG8306,2R,16589518,16594646,5128
FBgn0034141,Dolk,2R,16587045,16589184,2139
FBgn0034140,Lst,2R,16574579,16576586,2007
FBgn0034138,RpS15,2R,16570112,16571230,1118
FBgn0034136,DAT,2R,16558567,16565238,6671
FBgn0034094,Tsf3,2R,16226501,16229869,3368
FBgn0034095,CG15701,2R,16230198,16234087,3889
FBgn0034097,CG3687,2R,16236715,16237479,764
FBgn0053017,CG33017,2R,16272114,16277655,5541
FBgn0034103,prim,2R,16280015,16280470,455
FBgn0034104,CG15705,2R,16280950,16281629,679
FBgn0028424,JhI-26,2R,16289320,16291333,2013
FBgn0050100,CG30100,2R,16291453,16292269,816
FBgn0034110,Atg9,2R,16294400,16297232,2832
FBgn0034114,CG4282,2R,16322186,16324801,2615
FBgn0010611,Hmgs,2R,16336090,16341242,5152
FBgn0034118,Nup62,2R,16344377,16345828,1451
FBgn0034126,jtb,2R,16432244,16433183,939
FBgn0034128,CG4409,2R,16443211,16444845,1634
FBgn0034127,CG7848,2R,16433852,16435954,2102
FBgn0034117,CG7997,2R,16341251,16344182,2931
FBgn0050096,CG30096,2R,16320815,16322124,1309
FBgn0034113,CG8060,2R,16316313,16320732,4419
FBgn0034109,CG7747,2R,16292264,16294130,1866
FBgn0050099,CG30099,2R,16288208,16288969,761
FBgn0050324,CG30324,2R,16287586,16288233,647
FBgn0001308,Khc,2R,16266960,16271971,5011
FBgn0025519,fidipidine,2R,16262284,16264619,2335
FBgn0034098,krimp,2R,16238103,16240722,2619
FBgn0034096,CG7786,2R,16234358,16234936,578
FBgn0034093,CG15706,2R,16223218,16230680,7462
FBgn0034091,mrj,2R,16203329,16221793,18464
FBgn0050237,tRNA:Gln-CTG-1-1,2R,16207635,16207706,71
FBgn0050093,COX6AL,2R,15944028,15944567,539
FBgn0034059,CG8320,2R,15992408,15993707,1299
FBgn0034060,Tmem131,2R,16001181,16006901,5720
FBgn0034063,CG8389,2R,16008339,16013815,5476
FBgn0034065,Rrp42,2R,16014908,16016050,1142
FBgn0034067,CG8399,2R,16017737,16024627,6890
FBgn0034069,CG8401,2R,16028603,16030091,1488
FBgn0034070,SP2353,2R,16031930,16047243,15313
FBgn0014020,Rho1,2R,16102687,16107229,4542
FBgn0034075,Asph,2R,16110331,16116996,6665
FBgn0034076,Jhedup,2R,16117109,16119149,2040
FBgn0010052,Jhe,2R,16119793,16122773,2980
FBgn0050095,CG30095,2R,16123484,16124577,1093
FBgn0001124,Got1,2R,16138352,16141928,3576
FBgn0050094,CG30094,2R,16142202,16142935,733
FBgn0027091,CysRS,2R,16143147,16145906,2759
FBgn0034083,lbk,2R,16150123,16169519,19396
FBgn0015754,Lis-1,2R,16178826,16185103,6277
FBgn0034087,clu,2R,16186584,16194277,7693
FBgn0015295,Shark,2R,16199426,16202884,3458
FBgn0034086,CG8441,2R,16185122,16186506,1384
FBgn0034085,Ptp52F,2R,16171112,16178307,7195
FBgn0034084,CG8435,2R,16169600,16170861,1261
FBgn0034082,CG10734,2R,16157267,16158794,1527
FBgn0034073,CG8414,2R,16099306,16102608,3302
FBgn0034068,casp,2R,16024628,16028161,3533
FBgn0034066,EMC7,2R,16016042,16017154,1112
FBgn0010590,Prosbeta1,2R,16013805,16014787,982
FBgn0034062,CG8388,2R,16009401,16011438,2037
FBgn0034061,Ufc1,2R,16006893,16007667,774
FBgn0020236,Acly,2R,15993531,16001290,7759
FBgn0034058,Pex11ab,2R,15991367,15992375,1008
FBgn0034057,CG8314,2R,15989683,15991286,1603
FBgn0050090,Erasp,2R,15689826,15691014,1188
FBgn0050088,CG30088,2R,15691113,15692216,1103
FBgn0050089,CG30089,2R,15727381,15762044,34663
FBgn0034046,tun,2R,15794000,15855645,61645
FBgn0034047,cGlr1,2R,15855961,15857522,1561
FBgn0034050,bug,2R,15934825,15935938,1113
FBgn0034052,CG8299,2R,15940610,15941483,873
FBgn0034051,Mlf,2R,15935893,15940073,4180
FBgn0015247,Diap2,2R,15932170,15934825,2655
FBgn0034049,bdg,2R,15923040,15931935,8895
FBgn0050085,Rif1,2R,15864309,15869147,4838
FBgn0022160,Gpo1,2R,15857752,15862755,5003
FBgn0034045,CG8249,2R,15842760,15847362,4602
FBgn0003130,Poxn,2R,15826693,15835055,8362
FBgn0050083,CG30083,2R,15711597,15712644,1047
FBgn0050080,CG30080,2R,15698726,15701696,2970
FBgn0034025,Pgant1,2R,15511710,15515597,3887
FBgn0050467,CG30467,2R,15538175,15540014,1839
FBgn0022097,Vha36-1,2R,15541435,15542498,1063
FBgn0034029,eIF2Bgamma,2R,15542661,15544409,1748
FBgn0050466,CG30466,2R,15568960,15573170,4210
FBgn0034035,Gmppa,2R,15677218,15678956,1738
FBgn0023441,fus,2R,15657318,15676669,19351
FBgn0034033,CG8204,2R,15573144,15573991,847
FBgn0013762,Cdk5,2R,15569528,15571417,1889
FBgn0024754,Flo1,2R,15566271,15569404,3133
FBgn0034032,CG8195,2R,15562697,15565801,3104
FBgn0034030,CG8192,2R,15544316,15549984,5668
FBgn0034027,CG8187,2R,15539554,15541363,1809
FBgn0019968,Khc-73,2R,15515778,15532259,16481
FBgn0034022,CG12964,2R,15485953,15497231,11278
FBgn0034021,CG8180,2R,15472175,15482834,10659
FBgn0013467,igl,2R,15155437,15190292,34855
FBgn0033996,CG11807,2R,15201253,15204466,3213
FBgn0050081,Ir51b,2R,15207993,15209786,1793
FBgn0034000,CG11808,2R,15216207,15217070,863
FBgn0034002,CG8079,2R,15218379,15224795,6416
FBgn0034005,ItgaPS4,2R,15258761,15262873,4112
FBgn0004698,Xpc,2R,15311510,15318239,6729
FBgn0013750,Arf6,2R,15322501,15325490,2989
FBgn0034012,Hr51,2R,15331325,15339384,8059
FBgn0034013,unc-5,2R,15340472,15368300,27828
FBgn0014865,Mtk,2R,15408846,15409113,267
FBgn0000996,dup,2R,15376619,15380988,4369
FBgn0011660,Pms2,2R,15368074,15371520,3446
FBgn0034011,CG8160,2R,15327143,15328271,1128
FBgn0034010,CG8157,2R,15325503,15326386,883
FBgn0034008,CG8152,2R,15309931,15311134,1203
FBgn0034007,ND-51L2,2R,15296764,15298329,1565
FBgn0001187,Hex-C,2R,15218837,15220329,1492
FBgn0034001,mRpL41,2R,15217024,15217617,593
FBgn0033998,row,2R,15206527,15213634,7107
FBgn0033995,GPHR,2R,15199065,15201200,2135
FBgn0033982,Cyp317a1,2R,14898312,14903095,4783
FBgn0040747,CG12853,2R,14933515,14933913,398
FBgn0033984,Lap1,2R,14935660,14940722,5062
FBgn0033985,CG10257,2R,14942398,14944469,2071
FBgn0033987,ckn,2R,14963292,14980795,17503
FBgn0033988,pcs,2R,14981263,14991336,10073
FBgn0015371,chn,2R,15115236,15144783,29547
FBgn0033994,CG7544,2R,15147860,15149709,1849
FBgn0033993,CG8089,2R,15145825,15147824,1999
FBgn0033990,CG10265,2R,14992332,14993835,1503
FBgn0033989,CG7639,2R,14987660,14992230,4570
FBgn0033983,Agps,2R,14929703,14934861,5158
FBgn0027596,Kank,2R,14901475,14928425,26950
FBgn0033951,CG10139,2R,14645270,14646344,1074
FBgn0010388,Dro,2R,14745961,14746714,753
FBgn0012042,AttA,2R,14747362,14748215,853
FBgn0041581,AttB,2R,14749223,14750165,942
FBgn0050476,ave,2R,14752521,14753269,748
FBgn0033961,ND-B15,2R,14756516,14757072,556
FBgn0015602,BEAF-32,2R,14770469,14772630,2161
FBgn0033968,hui,2R,14808419,14809931,1512
FBgn0033970,CG10205,2R,14832832,14833951,1119
FBgn0028434,Ercc1,2R,14852941,14853948,1007
FBgn0033973,HPS1,2R,14855429,14857502,2073
FBgn0013773,Cyp6a22,2R,14871366,14873705,2339
FBgn0015714,Cyp6a17,2R,14873953,14875739,1786
FBgn0033978,Cyp6a23,2R,14875829,14877654,1825
FBgn0033979,Cyp6a19,2R,14877786,14879752,1966
FBgn0033980,Cyp6a20,2R,14882118,14884046,1928
FBgn0013772,Cyp6a8,2R,14887171,14889010,1839
FBgn0013771,Cyp6a9,2R,14879356,14881372,2016
FBgn0033972,Ciao1,2R,14853863,14855048,1185
FBgn0027783,SMC2,2R,14848621,14852653,4032
FBgn0033971,CG10209,2R,14846064,14848366,2302
FBgn0016684,NaPi-T,2R,14842720,14845874,3154
FBgn0033969,Pgm2b,2R,14817857,14819987,2130
FBgn0001319,kn,2R,14772650,14807061,34411
FBgn0020767,Spred,2R,14759646,14769423,9777
FBgn0033963,CG12857,2R,14757907,14759602,1695
FBgn0033960,CG10151,2R,14753337,14756288,2951
FBgn0028689,Rpn6,2R,14750166,14752910,2744
FBgn0033958,jef,2R,14739359,14745335,5976
FBgn0020269,mspo,2R,14671396,14713622,42226
FBgn0050480,CG30480,2R,14674606,14678136,3530
FBgn0050479,CG30479,2R,14674465,14678136,3671
FBgn0033954,CG12860,2R,14665641,14666817,1176
FBgn0033953,CG12861,2R,14664246,14665356,1110
FBgn0033932,Dh44-R1,2R,14378097,14385359,7262
FBgn0033935,Sin1,2R,14411825,14413851,2026
FBgn0033936,Achl,2R,14420324,14424764,4440
FBgn0050197,CG30197,2R,14514030,14514992,962
FBgn0033943,CG12869,2R,14591203,14595617,4414
FBgn0050077,Blos1,2R,14601278,14602010,732
FBgn0010638,Sec61beta,2R,14618771,14619681,910
FBgn0033949,Had2,2R,14629910,14631023,1113
FBgn0033948,CG12863,2R,14619798,14621320,1522
FBgn0026427,Su(var)2-HP2,2R,14607154,14618118,10964
FBgn0053468,CG33468,2R,14606307,14606980,673
FBgn0053469,CG33469,2R,14605652,14606302,650
FBgn0033945,CG12868,2R,14604549,14605297,748
FBgn0019938,Polr1A,2R,14595611,14601216,5605
FBgn0010397,LamC,2R,14570810,14575771,4961
FBgn0033942,Cpr51A,2R,14512559,14515211,2652
FBgn0013725,phyl,2R,14427336,14432337,5001
FBgn0033934,CG17385,2R,14409295,14411572,2277
FBgn0033899,CG13016,2R,14157762,14159434,1672
FBgn0033901,O-fut1,2R,14161430,14163054,1624
FBgn0033903,CG8323,2R,14165051,14166991,1940
FBgn0033904,CG18327,2R,14166982,14168233,1251
FBgn0033905,CG18324,2R,14168786,14170233,1447
FBgn0033906,ReepB,2R,14170462,14172998,2536
FBgn0000289,cg,2R,14173693,14182838,9145
FBgn0033913,CG8468,2R,14219898,14230620,10722
FBgn0033916,Usp20-33,2R,14239932,14243655,3723
FBgn0033917,SmydA-1,2R,14243778,14246066,2288
FBgn0033918,CG8531,2R,14256493,14258787,2294
FBgn0027538,beta4GalNAcTA,2R,14259030,14261150,2120
FBgn0033924,CG8613,2R,14352231,14355674,3443
FBgn0033928,Arc2,2R,14361924,14362825,901
FBgn0033929,Tfb1,2R,14363048,14365473,2425
FBgn0033927,CR10102,2R,14360433,14361780,1347
FBgn0033926,Arc1,2R,14357927,14360297,2370
FBgn0033925,CG8617,2R,14355769,14357281,1512
FBgn0033921,tej,2R,14300103,14302353,2250
FBgn0033919,CG8547,2R,14261206,14267919,6713
FBgn0001220,Hsc70-5,2R,14252598,14256192,3594
FBgn0033915,Snrk,2R,14235787,14239703,3916
FBgn0033912,RpS23,2R,14215096,14216627,1531
FBgn0005613,Sox15,2R,14201390,14212413,11023
FBgn0033907,mRpS16,2R,14172986,14173596,610
FBgn0033902,eIF3m,2R,14163066,14164825,1759
FBgn0033900,CysRS-m,2R,14159096,14161262,2166
FBgn0040751,CG13018,2R,14157050,14157488,438
FBgn0033897,Rcd1,2R,14148263,14153123,4860
FBgn0013770,CtsL1,2R,13960675,13967981,7306
FBgn0033891,CG8067,2R,13983395,13984893,1498
FBgn0002643,mam,2R,13991203,14060356,69153
FBgn0033893,CG18371,2R,14028620,14029096,476
FBgn0040752,Prosap,2R,14060456,14140902,80446
FBgn0020620,RN-tre,2R,13984815,13990707,5892
FBgn0033890,Ctf4,2R,13980362,13983317,2955
FBgn0033889,CG6701,2R,13972984,13980165,7181
FBgn0033888,CG18568,2R,13971325,13972834,1509
FBgn0033887,St4,2R,13969910,13971263,1353
FBgn0033886,Rpn13,2R,13958545,13960404,1859
FBgn0033885,DJ-1alpha,2R,13942534,13943377,843
FBgn0013733,shot,2R,13864237,13942110,77873
FBgn0033883,Mecr,2R,13860349,13862002,1653
FBgn0033859,fand,2R,13593644,13596557,2913
FBgn0033860,S-Lap5,2R,13596677,13598750,2073
FBgn0000633,tei,2R,13623044,13749367,126323
FBgn0033863,CG13337,2R,13665114,13667756,2642
FBgn0033864,CG18368,2R,13667736,13671594,3858
FBgn0033866,CG6280,2R,13753964,13758971,5007
FBgn0033867,Cpr50Ca,2R,13769915,13787802,17887
FBgn0033869,Cpr50Cb,2R,13794777,13805231,10454
FBgn0033871,CG13339,2R,13824858,13825572,714
FBgn0033872,CG6329,2R,13826371,13833503,7132
FBgn0033874,CtsL2,2R,13836419,13839363,2944
FBgn0033875,CG6357,2R,13840053,13841743,1690
FBgn0050485,CG30485,2R,13849882,13852983,3101
FBgn0033880,CG6553,2R,13854578,13855778,1200
FBgn0033879,Echs1,2R,13852947,13854331,1384
FBgn0033876,Syngr,2R,13841761,13846255,4494
FBgn0000662,fl(2)d,2R,13819624,13824553,4929
FBgn0033868,S-Lap7,2R,13778124,13780245,2121
FBgn0041579,AttC,2R,13393705,13394667,962
FBgn0053470,BaraA1,2R,13411739,13413085,1346
FBgn0040477,cid,2R,13485617,13486631,1014
FBgn0033845,mars,2R,13500621,13506011,5390
FBgn0033846,mip120,2R,13506430,13513112,6682
FBgn0024556,mEFTu1,2R,13507557,13509332,1775
FBgn0033848,CG13330,2R,13515259,13517452,2193
FBgn0033850,CG13331,2R,13521769,13523375,1606
FBgn0033851,CG13332,2R,13525377,13526448,1071
FBgn0014877,Roe1,2R,13554077,13555606,1529
FBgn0033855,link,2R,13555949,13557342,1393
FBgn0027581,CG6191,2R,13580313,13593339,13026
FBgn0053156,Nadk1b,2R,13548244,13553240,4996
FBgn0033853,Nadk1a,2R,13537371,13547577,10206
FBgn0004638,drk,2R,13495222,13502841,7619
FBgn0033844,bbc,2R,13486634,13494862,8228
FBgn0033842,cbc,2R,13483512,13485391,1879
FBgn0000119,arr,2R,13453640,13483229,29589
FBgn0050062,CG30062,2R,13445700,13446309,609
FBgn0260475,CG30059,2R,13412769,13414620,1851
FBgn0033836,CG18278,2R,13408042,13409887,1845
FBgn0033834,CG4744,2R,13394615,13399368,4753
FBgn0033830,CG10814,2R,13375975,13377731,1756
FBgn0033828,CG17048,2R,13353638,13354499,861
FBgn0033792,CG13325,2R,13110769,13126014,15245
FBgn0020391,Nrk,2R,13160063,13163484,3421
FBgn0053138,AGBE,2R,13171401,13174796,3395
FBgn0027079,ValRS,2R,13198850,13202709,3859
FBgn0033806,FLASH,2R,13206745,13210469,3724
FBgn0033808,CG4627,2R,13214706,13215760,1054
FBgn0040754,CG17059,2R,13220283,13221015,732
FBgn0011763,Dp,2R,13222433,13228202,5769
FBgn0033813,fsd,2R,13230583,13231663,1080
FBgn0033815,CG4676,2R,13235980,13237055,1075
FBgn0033817,GstE14,2R,13239729,13241013,1284
FBgn0033820,CG4716,2R,13256587,13257446,859
FBgn0033821,CG10799,2R,13257886,13258477,591
FBgn0033827,CG17047,2R,13298995,13301547,2552
FBgn0033819,CG4714,2R,13251852,13254337,2485
FBgn0033818,CG4712,2R,13248894,13251724,2830
FBgn0033816,CG4679,2R,13237256,13239468,2212
FBgn0033814,Qsox1,2R,13231758,13235296,3538
FBgn0033812,Pex13,2R,13228276,13230234,1958
FBgn0043010,Fsn,2R,13220939,13222459,1520
FBgn0005654,Orc3,2R,13202728,13206547,3819
FBgn0053182,Kdm4B,2R,13176553,13198337,21784
FBgn0033802,CG17724,2R,13176094,13190086,13992
FBgn0033799,GLaz,2R,13163959,13168032,4073
FBgn0033798,CG15870,2R,13163363,13163948,585
FBgn0020370,TppII,2R,13152885,13159141,6256
FBgn0033794,CG13326,2R,13129511,13132455,2944
FBgn0033793,CG3955,2R,13127915,13129052,1137
FBgn0028963,Or49b,2R,12842665,12844704,2039
FBgn0000181,bic,2R,12870249,12871794,1545
FBgn0002069,AspRS,2R,12877004,12883168,6164
FBgn0003975,vg,2R,12884201,12899385,15184
FBgn0033782,sug,2R,12924567,12930644,6077
FBgn0033785,Sans,2R,12936891,12940412,3521
FBgn0033791,Drl-2,2R,13055246,13079539,24293
FBgn0033788,CG13323,2R,13044695,13047256,2561
FBgn0005624,Psc,2R,12965997,12980994,14997
FBgn0004512,Mdr49,2R,12940323,12946347,6024
FBgn0033784,SCCRO3,2R,12934234,12936535,2301
FBgn0033783,CG17019,2R,12930912,12934045,3133
FBgn0025692,Lfg,2R,12875164,12876966,1802
FBgn0033778,Balat,2R,12872787,12875012,2225
FBgn0033777,CG17574,2R,12849358,12869423,20065
FBgn0050488,antr,2R,12846848,12848004,1156
FBgn0033775,Cyp9h1,2R,12840813,12842558,1745
FBgn0011592,fra,2R,12529053,12564184,35131
FBgn0033753,Cyp301a1,2R,12566185,12569061,2876
FBgn0033755,ClC-b,2R,12572068,12575299,3231
FBgn0050055,lncRNA:CR30055,2R,12589239,12591395,2156
FBgn0027356,Amph,2R,12593604,12612068,18464
FBgn0004435,Galphaq,2R,12612740,12623197,10457
FBgn0050054,CG30054,2R,12623726,12625352,1626
FBgn0033756,CG17760,2R,12625808,12628619,2811
FBgn0028683,spt4,2R,12633589,12634172,583
FBgn0011604,Iswi,2R,12636671,12640628,3957
FBgn0033762,ZnT49B,2R,12652805,12655743,2938
FBgn0033763,CG8646,2R,12655954,12659341,3387
FBgn0033767,CG13148,2R,12686249,12688786,2537
FBgn0026741,mRpL18,2R,12756434,12757173,739
FBgn0020930,Dgkepsilon,2R,12757546,12759724,2178
FBgn0033774,CG12374,2R,12762113,12763825,1712
FBgn0003326,sca,2R,12780541,12802010,21469
FBgn0011227,ox,2R,12757133,12757529,396
FBgn0026619,Taz,2R,12753026,12756414,3388
FBgn0033773,Mos,2R,12751483,12752936,1453
FBgn0033769,CG8768,2R,12691308,12692690,1382
FBgn0050052,Obp49a,2R,12690059,12690955,896
FBgn0050053,CG30053,2R,12688733,12689876,1143
FBgn0033766,Nup188,2R,12679967,12686179,6212
FBgn0033761,CG8778,2R,12651301,12652487,1186
FBgn0033760,CG8785,2R,12640690,12648224,7534
FBgn0033757,muskelin,2R,12628697,12632378,3681
FBgn0022764,Sin3A,2R,12575240,12592917,17677
FBgn0033754,Ak6,2R,12569014,12569847,833
FBgn0033710,CG17739,2R,12306528,12310412,3884
FBgn0050203,CG30203,2R,12310689,12313834,3145
FBgn0050046,CG30046,2R,12314117,12317573,3456
FBgn0033715,CG8490,2R,12335316,12336205,889
FBgn0033716,Den1,2R,12337797,12339544,1747
FBgn0050047,CG30047,2R,12351793,12355413,3620
FBgn0050045,Cpr49Aa,2R,12376626,12377378,752
FBgn0050042,Cpr49Ab,2R,12378440,12379396,956
FBgn0033724,CG8501,2R,12383045,12384520,1475
FBgn0033725,Cpr49Ac,2R,12386666,12390057,3391
FBgn0033728,Cpr49Ae,2R,12402216,12405108,2892
FBgn0033729,Cpr49Af,2R,12405932,12407045,1113
FBgn0033730,Cpr49Ag,2R,12407793,12408523,730
FBgn0050050,CG30050,2R,12408954,12409735,781
FBgn0033731,Cpr49Ah,2R,12413962,12415170,1208
FBgn0033734,CG8520,2R,12422931,12425459,2528
FBgn0033735,Dera,2R,12425483,12426975,1492
FBgn0050051,Tmem18,2R,12436120,12436990,870
FBgn0010238,Lac,2R,12453190,12465630,12440
FBgn0033741,CG8545,2R,12468651,12471722,3071
FBgn0033742,Nepl10,2R,12471915,12474021,2106
FBgn0033744,Dh44-R2,2R,12474424,12487986,13562
FBgn0050044,s-cup,2R,12495672,12501459,5787
FBgn0033750,CG13151,2R,12515375,12517284,1909
FBgn0033752,CG8569,2R,12519166,12521624,2458
FBgn0033751,CG8818,2R,12517264,12518912,1648
FBgn0033749,achi,2R,12511534,12515062,3528
FBgn0033748,vis,2R,12507896,12510615,2719
FBgn0045063,fdl,2R,12487451,12507333,19882
FBgn0033740,dgt5,2R,12465678,12471775,6097
FBgn0050334,CG30334,2R,12440633,12441320,687
FBgn0033738,DUBAI,2R,12431447,12436577,5130
FBgn0033737,Nup54,2R,12428449,12431099,2650
FBgn0033736,CG13154,2R,12426883,12427861,978
FBgn0033733,CG8834,2R,12420475,12422535,2060
FBgn0033723,CG13155,2R,12379614,12380426,812
FBgn0033717,CG8839,2R,12339610,12344617,5007
FBgn0033713,CG8841,2R,12322507,12326258,3751
FBgn0033677,CG8321,2R,12033946,12036260,2314
FBgn0024732,Drep1,2R,12044612,12050172,5560
FBgn0028407,Drep3,2R,12055089,12062866,7777
FBgn0033683,CG18343,2R,12138695,12139324,629
FBgn0027495,Smyd4-4,2R,12140631,12143272,2641
FBgn0033686,Hen1,2R,12145710,12152752,7042
FBgn0033687,CG8407,2R,12153071,12154263,1192
FBgn0023167,SmD3,2R,12168731,12170003,1272
FBgn0010621,CCT5,2R,12174802,12177516,2714
FBgn0033692,wash,2R,12180493,12182373,1880
FBgn0025454,Cyp6g1,2R,12185667,12188431,2764
FBgn0033697,Cyp6t3,2R,12190682,12192436,1754
FBgn0033705,CG13168,2R,12253992,12255701,1709
FBgn0033706,Vha36-2,2R,12257282,12258652,1370
FBgn0000253,Cam,2R,12259398,12278809,19411
FBgn0033702,CG8854,2R,12224461,12229310,4849
FBgn0020377,Sr-CII,2R,12208893,12212155,3262
FBgn0033699,RpS11,2R,12199024,12200815,1791
FBgn0033698,CG8858,2R,12192374,12198854,6480
FBgn0033696,Cyp6g2,2R,12188338,12190377,2039
FBgn0000426,SmF,2R,12183844,12184310,466
FBgn0033691,CG8860,2R,12179483,12179902,419
FBgn0033690,EndoG,2R,12177430,12178553,1123
FBgn0014184,Oda,2R,12166295,12174264,7969
FBgn0033688,Prp8,2R,12154258,12162998,8740
FBgn0027504,bsd,2R,12146024,12151057,5033
FBgn0033685,OSCP1,2R,12143191,12144533,1342
FBgn0026176,SkpB,2R,12139295,12140229,934
FBgn0033679,CG8888,2R,12064565,12079543,14978
FBgn0050039,CG30039,2R,12050977,12051755,778
FBgn0004839,otk,2R,12001473,12019846,18373
FBgn0033650,CG13193,2R,11768453,11769561,1108
FBgn0033653,CG13192,2R,11825345,11827097,1752
FBgn0033657,Sln,2R,11845324,11852324,7000
FBgn0013756,Mgtor,2R,11852617,11861202,8585
FBgn0015543,snoRNA:Me28S-A1322,2R,11893123,11893195,72
FBgn0033665,Zip48C,2R,11899517,11901394,1877
FBgn0033668,exp,2R,11939557,11967435,27878
FBgn0026573,ADD1,2R,11970686,11977721,7035
FBgn0033673,CG8298,2R,11989131,11992350,3219
FBgn0033672,rho-7,2R,11986513,11988787,2274
FBgn0011704,RnrS,2R,11983145,11985393,2248
FBgn0053145,GalT1,2R,11980577,11982956,2379
FBgn0033669,PI31,2R,11967343,11970115,2772
FBgn0033667,reb,2R,11904323,11912779,8456
FBgn0033663,ERp60,2R,11887568,11890979,3411
FBgn0033661,CG13185,2R,11867876,11885585,17709
FBgn0033658,Twdlbeta,2R,11862537,11863252,715
FBgn0033656,S2P,2R,11842103,11844240,2137
FBgn0033654,Sobp,2R,11827170,11839825,12655
FBgn0033640,CG13198,2R,11654898,11655762,864
FBgn0050035,Tret1-1,2R,11665768,11674782,9014
FBgn0033644,Tret1-2,2R,11675935,11678014,2079
FBgn0040491,Buffy,2R,11679492,11688557,9065
FBgn0062449,CG13197,2R,11691285,11697785,6500
FBgn0033649,pyr,2R,11712263,11726345,14082
FBgn0010516,wal,2R,11688569,11690863,2294
FBgn0044020,Roc2,2R,11652756,11679354,26598
FBgn0033639,CG9003,2R,11641477,11651616,10139
FBgn0033638,atos,2R,11619479,11640941,21462
FBgn0033636,tou,2R,11577485,11616045,38560
FBgn0003396,shn,2R,11159086,11217394,58308
FBgn0037084,Syx6,2R,11219539,11222480,2941
FBgn0033584,CG7737,2R,11222871,11226746,3875
FBgn0033594,CG13226,2R,11244247,11245199,952
FBgn0033602,Cpr47Ee,2R,11265126,11266856,1730
FBgn0041174,Vhl,2R,11279725,11281033,1308
FBgn0033608,CG13220,2R,11284283,11285098,815
FBgn0050033,CG30033,2R,11292531,11293591,1060
FBgn0033615,CG7741,2R,11301916,11305607,3691
FBgn0033616,CG7745,2R,11307879,11309829,1950
FBgn0003382,sha,2R,11324314,11336463,12149
FBgn0010357,betaTry,2R,11346325,11347395,1070
FBgn0015001,iotaTry,2R,11356720,11357537,817
FBgn0024188,san,2R,11360706,11361871,1165
FBgn0041241,Gr47b,2R,11361900,11363405,1505
FBgn0033627,CG13204,2R,11366710,11370287,3577
FBgn0033635,Prip,2R,11436243,11442216,5973
FBgn0000581,E(Pc),2R,11452043,11465270,13227
FBgn0082585,sprt,2R,11384743,11397432,12689
FBgn0050022,CG30022,2R,11387160,11388779,1619
FBgn0033629,Tsp47F,2R,11377193,11379177,1984
FBgn0021795,Tapdelta,2R,11370300,11371335,1035
FBgn0001276,ix,2R,11359437,11360163,726
FBgn0033624,CG12384,2R,11357902,11359176,1274
FBgn0033623,CG13202,2R,11356114,11356600,486
FBgn0010425,epsilonTry,2R,11345237,11346066,829
FBgn0003863,alphaTry,2R,11344260,11345119,859
FBgn0043471,kappaTry,2R,11337797,11338733,936
FBgn0025373,Fpps,2R,11305511,11307528,2017
FBgn0040763,CG18336,2R,11293776,11294586,810
FBgn0015582,dare,2R,11290994,11293174,2180
FBgn0033610,CG18335,2R,11289688,11291096,1408
FBgn0033609,Fbl6,2R,11285148,11289772,4624
FBgn0033607,CG9062,2R,11280484,11283971,3487
FBgn0033605,CG9067,2R,11278893,11279683,790
FBgn0010423,TpnC47D,2R,11273845,11275286,1441
FBgn0033603,Cpr47Ef,2R,11266915,11272575,5660
FBgn0033597,Cpr47Ea,2R,11251751,11253398,1647
FBgn0033593,Listericin,2R,11241745,11242194,449
FBgn0033592,CG13215,2R,11239494,11240114,620
FBgn0050021,metro,2R,11226458,11232516,6058
FBgn0033582,CG9084,2R,11217416,11219771,2355
FBgn0033573,Obp47a,2R,10909923,10910485,562
FBgn0033578,BBS4,2R,11135923,11139315,3392
FBgn0033581,CG12391,2R,11147602,11150068,2466
FBgn0033579,CG13229,2R,11139304,11172206,32902
FBgn0040765,luna,2R,10977956,11116378,138422
FBgn0033574,Spn47C,2R,10938425,10941738,3313
FBgn0033542,CAH13,2R,10725270,10727272,2002
FBgn0033544,CG7220,2R,10731335,10738370,7035
FBgn0033547,CG12935,2R,10809397,10810655,1258
FBgn0033549,mms4,2R,10811078,10812215,1137
FBgn0033551,CG7222,2R,10813405,10815781,2376
FBgn0029134,Prosbeta5,2R,10819978,10821178,1200
FBgn0033555,RpS15Ab,2R,10821676,10822399,723
FBgn0033557,CG12325,2R,10823405,10827644,4239
FBgn0050020,CG30020,2R,10886810,10893191,6381
FBgn0033569,CG12942,2R,10894459,10897222,2763
FBgn0033571,Polr2E,2R,10898031,10899060,1029
FBgn0033570,ND-B14,2R,10897144,10897885,741
FBgn0017414,cag,2R,10893034,10894414,1380
FBgn0010356,Taf5,2R,10877312,10879673,2361
FBgn0050016,CG30016,2R,10874892,10875392,500
FBgn0050015,CG30015,2R,10839102,10874771,35669
FBgn0027525,LTV1,2R,10836570,10838727,2157
FBgn0033558,alka,2R,10827430,10835709,8279
FBgn0033556,CG12343,2R,10822400,10823372,972
FBgn0033554,Lsm10,2R,10821098,10821640,542
FBgn0033550,CG12341,2R,10812157,10813310,1153
FBgn0033548,Nop10,2R,10810556,10810936,380
FBgn0027499,wde,2R,10800420,10808938,8518
FBgn0053144,CG33144,2R,10740054,10798709,58655
FBgn0024956,Mat1,2R,10738617,10739829,1212
FBgn0033543,Daao1,2R,10729578,10731528,1950
FBgn0005586,Rab3,2R,10721335,10729203,7868
FBgn0033518,Prx6c,2R,10418718,10419761,1043
FBgn0053474,CG33474,2R,10421706,10422989,1283
FBgn0033520,Prx6b,2R,10424436,10425471,1035
FBgn0001122,Galphao,2R,10437985,10465701,27716
FBgn0033527,CG11777,2R,10468616,10469643,1027
FBgn0033529,Pef,2R,10480163,10481886,1723
FBgn0033528,trsn,2R,10479011,10480111,1100
FBgn0033526,Caf1-105,2R,10466001,10468540,2539
FBgn0033524,Cyp49a1,2R,10449350,10458892,9542
FBgn0033523,CG12895,2R,10436598,10437382,784
FBgn0033521,CG12896,2R,10426880,10427915,1035
FBgn0033519,CG11825,2R,10420414,10423650,3236
FBgn0053475,CG33475,2R,10410770,10411213,443
FBgn0053477,CG33477,2R,10409155,10409751,596
FBgn0033515,Ir47a,2R,10377128,10380109,2981
FBgn0026388,Or46a,2R,10139264,10142074,2810
FBgn0033491,CG18011,2R,10142338,10146206,3868
FBgn0005619,Hdc,2R,10237988,10246077,8089
FBgn0033499,CG12914,2R,10247814,10249404,1590
FBgn0033500,Csgalnact,2R,10249220,10255495,6275
FBgn0033501,CG12911,2R,10256686,10261276,4590
FBgn0033502,CG12910,2R,10265057,10269205,4148
FBgn0033504,CAP,2R,10269016,10307024,38008
FBgn0033507,CG12909,2R,10310113,10311143,1030
FBgn0026403,Ndg,2R,10313891,10322104,8213
FBgn0033512,CG12902,2R,10354724,10355831,1107
FBgn0028426,RNaseZ,2R,10307030,10309794,2764
FBgn0003660,Syb,2R,10249435,10252417,2982
FBgn0033498,CG12209,2R,10246071,10247560,1489
FBgn0033497,CG12912,2R,10205454,10234607,29153
FBgn0000448,Hr3,2R,10203995,10237348,33353
FBgn0033494,KCNQ,2R,10145897,10192394,46497
FBgn0033454,CG1671,2R,9848061,9850642,2581
FBgn0050010,CG30010,2R,9863564,9864576,1012
FBgn0033457,Ntmt,2R,9865632,9867051,1419
FBgn0033458,Lime,2R,9871470,9873646,2176
FBgn0033459,CG12744,2R,9874889,9876242,1353
FBgn0033461,CG12923,2R,9887648,9889485,1837
FBgn0050008,CG30008,2R,9889878,9891141,1263
FBgn0000715,FMRFa,2R,9906294,9910457,4163
FBgn0027619,eIF3j,2R,9968929,9970897,1968
FBgn0033471,CG12134,2R,9971143,9972780,1637
FBgn0000606,eve,2R,9979319,9980795,1476
FBgn0033473,CG12128,2R,10026839,10030668,3829
FBgn0033475,CG12129,2R,10033304,10034698,1394
FBgn0040773,COX7C,2R,10048353,10050066,1713
FBgn0033480,mRpL42,2R,10066650,10067242,592
FBgn0033481,CG12920,2R,10069106,10071067,1961
FBgn0033483,egr,2R,10078366,10084210,5844
FBgn0033484,CG2269,2R,10085169,10096416,11247
FBgn0001291,Jra,2R,10096480,10098556,2076
FBgn0003071,Pfk,2R,10109740,10117457,7717
FBgn0033486,dmpd,2R,10117694,10121451,3757
FBgn0010531,Ccs,2R,10121486,10122574,1088
FBgn0033485,RpLP0-like,2R,10098518,10099590,1072
FBgn0033482,CG1371,2R,10070981,10075645,4664
FBgn0013435,Cdc2rk,2R,10067217,10068702,1485
FBgn0033479,PIG-N,2R,10063385,10066514,3129
FBgn0010385,Def,2R,10054178,10054576,398
FBgn0033476,oys,2R,10034595,10048619,14024
FBgn0033474,CG1407,2R,10028443,10032893,4450
FBgn0022382,Pka-R2,2R,9993890,10026042,32152
FBgn0033468,CG1418,2R,9963835,9965067,1232
FBgn0033467,Pdrg1,2R,9959119,9959732,613
FBgn0011656,Mef2,2R,9913496,9958858,45362
FBgn0033464,CG1441,2R,9899018,9903287,4269
FBgn0033463,CG1513,2R,9882572,9891689,9117
FBgn0033460,Sec24AB,2R,9876232,9882357,6125
FBgn0027580,PCB,2R,9850703,9861543,10840
FBgn0050000,GstT1,2R,9605988,9607184,1196
FBgn0050005,GstT2,2R,9607292,9608350,1058
FBgn0260474,CG30002,2R,9704384,9706147,1763
FBgn0033439,CG1773,2R,9706267,9707580,1313
FBgn0033440,CG10459,2R,9707536,9708722,1186
FBgn0005614,trpl,2R,9753697,9765518,11821
FBgn0033443,CG1698,2R,9793326,9798006,4680
FBgn0040092,lectin-46Cb,2R,9815510,9816600,1090
FBgn0040093,lectin-46Ca,2R,9817300,9818535,1235
FBgn0033449,CG1663,2R,9836985,9838481,1496
FBgn0033451,Marc,2R,9839776,9841163,1387
FBgn0023180,Orc6,2R,9845458,9846485,1027
FBgn0033450,Lsm11,2R,9838434,9839500,1066
FBgn0033448,hebe,2R,9828104,9836642,8538
FBgn0033447,dila,2R,9823082,9827206,4124
FBgn0050001,CG30001,2R,9821168,9822955,1787
FBgn0033446,CG1648,2R,9810974,9820053,9079
FBgn0027589,CG1688,2R,9766364,9806875,40511
FBgn0033442,CG1690,2R,9756293,9758068,1775
FBgn0023143,Uba1,2R,9688289,9693328,5039
FBgn0033438,Mmp2,2R,9611139,9683858,72719
FBgn0033437,CG12926,2R,9608128,9610290,2162
FBgn0016970,l(2)k10201,2R,9399080,9399899,819
FBgn0041087,wun2,2R,9414342,9417846,3504
FBgn0033413,prel,2R,9424087,9426107,2020
FBgn0017558,Pdk,2R,9426439,9434638,8199
FBgn0004360,Wnt2,2R,9494166,9503188,9022
FBgn0033422,Or45b,2R,9559598,9561068,1470
FBgn0033423,Alp6,2R,9561638,9563871,2233
FBgn0033426,Nt5c,2R,9577427,9581847,4420
FBgn0033428,Urod,2R,9584643,9586126,1483
FBgn0033431,CG1827,2R,9589050,9590443,1393
FBgn0010342,Map60,2R,9590867,9592744,1877
FBgn0033434,CG1902,2R,9594045,9605624,11579
FBgn0050338,CG30338,2R,9594045,9599505,5460
FBgn0033429,CG12929,2R,9586110,9586714,604
FBgn0033427,Smyd4-1,2R,9581761,9584545,2784
FBgn0033421,CG1888,2R,9541947,9548135,6188
FBgn0029092,ced-6,2R,9434669,9444937,10268
FBgn0033412,CG13955,2R,9421972,9423688,1716
FBgn0016078,wun,2R,9400531,9413463,12932
FBgn0028473,Non1,2R,9396265,9398734,2469
FBgn0033405,CG13954,2R,9309296,9389467,80171
FBgn0011746,ana,2R,9062295,9077554,15259
FBgn0025709,CNT2,2R,9078721,9082374,3653
FBgn0033371,CNT1,2R,9082395,9085717,3322
FBgn0010220,Dbp45A,2R,9087834,9089802,1968
FBgn0033376,CG8777,2R,9098539,9103153,4614
FBgn0015838,Vang,2R,9103238,9106796,3558
FBgn0033378,tsu,2R,9110799,9111578,779
FBgn0003612,Su(var)2-10,2R,9116122,9122000,5878
FBgn0033381,GstE13,2R,9122125,9123309,1184
FBgn0033382,Hydr1,2R,9132480,9135453,2973
FBgn0028955,CG8788,2R,9138486,9141981,3495
FBgn0050342,Prp38,2R,9143956,9145151,1195
FBgn0050344,CG30344,2R,9145260,9148512,3252
FBgn0050345,CG30345,2R,9148689,9151892,3203
FBgn0033389,Rad51D,2R,9165632,9167670,2038
FBgn0015561,unpg,2R,9195205,9199870,4665
FBgn0033395,Cyp4p2,2R,9237512,9239831,2319
FBgn0015037,Cyp4p1,2R,9240041,9242139,2098
FBgn0033397,Cyp4p3,2R,9242320,9244410,2090
FBgn0050343,Tsen15,2R,9252021,9253255,1234
FBgn0033401,Cog6,2R,9286827,9289026,2199
FBgn0028408,Drep2,2R,9291856,9302821,10965
FBgn0033402,Myd88,2R,9302823,9308722,5899
FBgn0026326,Mad1,2R,9288957,9291565,2608
FBgn0033400,CG2063,2R,9285310,9286634,1324
FBgn0020621,Pkn,2R,9252310,9285097,32787
FBgn0033392,Gnptab,2R,9204410,9207124,2714
FBgn0033391,CG8026,2R,9186670,9192096,5426
FBgn0015477,Rme-8,2R,9167763,9177261,9498
FBgn0033388,CG8046,2R,9162037,9164967,2930
FBgn0033387,CG8008,2R,9157907,9161436,3529
FBgn0027561,CG18659,2R,9123304,9132030,8726
FBgn0033379,Mys45A,2R,9111505,9113951,2446
FBgn0033377,Pgm2a,2R,9107151,9109718,2567
FBgn0033375,Ctu1,2R,9096931,9098525,1594
FBgn0033374,Boot,2R,9092506,9094658,2152
FBgn0033373,Nadk2,2R,9089774,9092893,3119
FBgn0033372,CG13742,2R,9084598,9087808,3210
FBgn0024189,sns,2R,8798489,8856091,57602
FBgn0050350,CG30350,2R,8826391,8827755,1364
FBgn0011286,RyR,2R,8860364,8888097,27733
FBgn0021825,DCTN2-p50,2R,8891832,8893339,1507
FBgn0033339,Sec31,2R,8893613,8898798,5185
FBgn0033340,CG13751,2R,8900241,8900617,376
FBgn0004921,Ggamma1,2R,8901404,8904791,3387
FBgn0050349,CG30349,2R,8907518,8910885,3367
FBgn0002552,lin,2R,8914524,8918234,3710
FBgn0033349,CG8243,2R,8922785,8925346,2561
FBgn0033350,CG8237,2R,8925671,8926890,1219
FBgn0033352,PAN2,2R,8928169,8933103,4934
FBgn0033357,Tom7,2R,8951595,8952242,647
FBgn0011300,babo,2R,8952339,8962796,10457
FBgn0033364,CG13747,2R,9017815,9019032,1217
FBgn0033368,CG13743,2R,9044850,9060608,15758
FBgn0033367,PPO2,2R,9042261,9044709,2448
FBgn0033366,Ance-4,2R,9039728,9042142,2414
FBgn0033365,CG8170,2R,9019032,9031045,12013
FBgn0033362,CG8172,2R,9007234,9013526,6292
FBgn0033358,spab,2R,8963164,8968184,5020
FBgn0033356,CG8229,2R,8948113,8951086,2973
FBgn0027607,CG8230,2R,8944298,8947344,3046
FBgn0033354,FANCI,2R,8934576,8939789,5213
FBgn0033351,AIMP1,2R,8927014,8928105,1091
FBgn0033348,Spt,2R,8920270,8922755,2485
FBgn0033347,CG8248,2R,8918940,8920368,1428
FBgn0003074,Pgi,2R,8910900,8914069,3169
FBgn0033341,MrgBP,2R,8900566,8901375,809
FBgn0027513,ana2,2R,8898729,8900211,1482
FBgn0033337,CG8272,2R,8888404,8891401,2997
FBgn0053199,CG33199,2R,8947681,8951086,3405
FBgn0033303,Cyp6a15Psi,2R,8569137,8570306,1169
FBgn0033304,Cyp6a13,2R,8570499,8572147,1648
FBgn0033307,CG14752,2R,8590497,8591948,1451
FBgn0033313,Cirl,2R,8614722,8625203,10481
FBgn0022027,Vps25,2R,8625451,8626180,729
FBgn0033316,Gle1,2R,8627900,8630186,2286
FBgn0050354,UQCR-11L,2R,8677219,8677661,442
FBgn0001285,Jon44E,2R,8691448,8692844,1396
FBgn0033321,CG8738,2R,8696428,8698583,2155
FBgn0033323,CG12376,2R,8701835,8704502,2667
FBgn0043576,PGRP-SC1a,2R,8709733,8710320,587
FBgn0033327,PGRP-SC1b,2R,8713446,8715094,1648
FBgn0043575,PGRP-SC2,2R,8716950,8717695,745
FBgn0005695,gcl,2R,8724258,8728999,4741
FBgn0033330,CG8746,2R,8792633,8793773,1140
FBgn0050356,CG30356,2R,8728964,8729501,537
FBgn0040777,CG14767,2R,8718017,8723839,5822
FBgn0050357,CG30357,2R,8720100,8721624,1524
FBgn0033326,CG14743,2R,8710398,8712913,2515
FBgn0033320,CG8586,2R,8692796,8696245,3449
FBgn0050355,CG30355,2R,8679146,8679953,807
FBgn0033317,CG8635,2R,8630207,8631962,1755
FBgn0033315,beta3GalTII,2R,8626181,8627611,1430
FBgn0033312,CG8642,2R,8611379,8614155,2776
FBgn0033309,Lnpk,2R,8596972,8599962,2990
FBgn0033308,CG8736,2R,8594031,8595001,970
FBgn0033302,Cyp6a14,2R,8564187,8567202,3015
FBgn0033283,CG11635,2R,8358538,8359472,934
FBgn0033287,CG8701,2R,8371073,8372142,1069
FBgn0028836,CSN7,2R,8421033,8428577,7544
FBgn0014469,Cyp4e2,2R,8444560,8447164,2604
FBgn0015034,Cyp4e1,2R,8447451,8449745,2294
FBgn0002569,Mal-A2,2R,8453627,8455782,2155
FBgn0050359,Mal-A5,2R,8462753,8465092,2339
FBgn0050360,Mal-A6,2R,8465158,8467595,2437
FBgn0050361,mtt,2R,8473956,8532294,58338
FBgn0002570,Mal-A1,2R,8449664,8451904,2240
FBgn0033292,Cyp4ad1,2R,8439395,8442806,3411
FBgn0002531,Lcp1,2R,8430115,8431243,1128
FBgn0033289,CG2121,2R,8396397,8411767,15370
FBgn0033286,CG2127,2R,8368344,8370038,1694
FBgn0028563,sut1,2R,8082976,8087151,4175
FBgn0028562,sut2,2R,8087396,8089297,1901
FBgn0028561,sut3,2R,8089482,8091297,1815
FBgn0033257,sand,2R,8091696,8096948,5252
FBgn0033259,Tmem63,2R,8098684,8102306,3622
FBgn0033261,udd,2R,8106385,8107373,988
FBgn0033264,Nup50,2R,8123036,8125058,2022
FBgn0033266,Socs44A,2R,8127575,8129476,1901
FBgn0005648,Pabp2,2R,8131431,8134374,2943
FBgn0021995,Rs1,2R,8163564,8167769,4205
FBgn0033273,Gasz,2R,8167948,8170089,2141
FBgn0011659,Mlh1,2R,8170274,8172401,2127
FBgn0053087,LRP1,2R,8174165,8226438,52273
FBgn0013726,pnut,2R,8237271,8240297,3026
FBgn0033277,CG14760,2R,8254223,8256931,2708
FBgn0050371,CG30371,2R,8267643,8269334,1691
FBgn0050376,CG30376,2R,8263486,8264426,940
FBgn0010109,dpn,2R,8228971,8232330,3359
FBgn0033274,CG14757,2R,8172364,8173613,1249
FBgn0050373,CG30373,2R,8164000,8164869,869
FBgn0033272,RagC-D,2R,8161679,8163500,1821
FBgn0010504,kermit,2R,8146918,8156654,9736
FBgn0033268,Obp44a,2R,8134170,8135315,1145
FBgn0033260,Cul4,2R,8102260,8106318,4058
FBgn0033258,uno,2R,8096792,8098484,1692
FBgn0025469,slv,2R,8080559,8083357,2798
FBgn0021814,Vps28,2R,8078869,8080041,1172
FBgn0040778,CG17977,2R,8066274,8067655,1381
FBgn0033252,CG12769,2R,8052080,8065554,13474
FBgn0033221,CG12825,2R,7789206,7789988,782
FBgn0033222,CG12824,2R,7790368,7791170,802
FBgn0002891,PolZ1,2R,7793625,7801044,7419
FBgn0003317,sax,2R,7806484,7810067,3583
FBgn0033226,puml,2R,7812504,7815486,2982
FBgn0003082,phr,2R,7825289,7827319,2030
FBgn0033229,CG12822,2R,7832171,7833841,1670
FBgn0040780,Atg10,2R,7832171,7835518,3347
FBgn0050377,CG30377,2R,7890025,7915032,25007
FBgn0015509,Cul1,2R,7916856,7921579,4723
FBgn0033234,MFS12,2R,7926653,7929922,3269
FBgn0026722,drosha,2R,7932429,7936840,4411
FBgn0050379,CG30379,2R,7939956,7941870,1914
FBgn0050378,CG30378,2R,7950339,7951492,1153
FBgn0033240,CG2906,2R,7956150,7958254,2104
FBgn0027548,nito,2R,7962463,7969805,7342
FBgn0027054,CSN4,2R,7972175,7974099,1924
FBgn0033247,Nup44A,2R,7988462,7991283,2821
FBgn0013307,Odc1,2R,8004824,8006672,1848
FBgn0013308,Odc2,2R,8007246,8009062,1816
FBgn0033249,CG11191,2R,8000490,8002120,1630
FBgn0027788,Hey,2R,7995438,7998278,2840
FBgn0033246,ACC,2R,7974115,7991862,17747
FBgn0033244,CG8726,2R,7968129,7972003,3874
FBgn0033243,CG14763,2R,7966029,7968024,1995
FBgn0026361,Septin5,2R,7960133,7961921,1788
FBgn0033241,CG2915,2R,7958207,7960015,1808
FBgn0033236,CG14764,2R,7942043,7955882,13839
FBgn0050380,CG30380,2R,7939201,7939659,458
FBgn0033235,CG8728,2R,7936866,7939114,2248
FBgn0023171,rnh1,2R,7931054,7932380,1326
FBgn0050381,PIG-X,2R,7929658,7931016,1358
FBgn0033233,Kdm4A,2R,7922775,7924988,2213
FBgn0026393,Or43b,2R,7920835,7922604,1769
FBgn0033232,CG12159,2R,7915027,7916478,1451
FBgn0050382,Prosalpha1R,2R,7830413,7831771,1358
FBgn0029093,cathD,2R,7815339,7823569,8230
FBgn0033225,TTLL12,2R,7810068,7812028,1960
FBgn0033224,Nop17l,2R,7800785,7806385,5600
FBgn0033187,PIG-G,2R,7519280,7522541,3261
FBgn0033190,Gpo2,2R,7535919,7538297,2378
FBgn0033192,Corin,2R,7540111,7564435,24324
FBgn0033194,Vps13,2R,7566809,7580675,13866
FBgn0050491,CG30491,2R,7655072,7656770,1698
FBgn0050495,CG30495,2R,7656895,7659061,2166
FBgn0033203,CG2070,2R,7661855,7663408,1553
FBgn0033204,CG2065,2R,7663786,7665269,1483
FBgn0033205,Rdh1,2R,7665828,7667343,1515
FBgn0033209,CG12107,2R,7674450,7675362,912
FBgn0050493,Coq9,2R,7699253,7703501,4248
FBgn0050496,CG30496,2R,7699500,7701878,2378
FBgn0033214,CG1941,2R,7709873,7711981,2108
FBgn0033215,Dgat2,2R,7712578,7714182,1604
FBgn0033216,CG1946,2R,7714923,7716781,1858
FBgn0015614,CanB2,2R,7786010,7789053,3043
FBgn0000337,cn,2R,7782797,7785067,2270
FBgn0042135,Gdap2,2R,7716807,7735622,18815
FBgn0003733,tor,2R,7705183,7709184,4001
FBgn0033212,LRR,2R,7676540,7698902,22362
FBgn0033210,U2A,2R,7675362,7676362,1000
FBgn0033208,mRpL52,2R,7673721,7674400,679
FBgn0033207,CG12826,2R,7670327,7671103,776
FBgn0033206,DCTN4-p62,2R,7667248,7669029,1781
FBgn0033199,ima,2R,7651625,7655302,3677
FBgn0028687,Rpt1,2R,7652440,7653954,1514
FBgn0033196,HisT,2R,7595265,7620711,25446
FBgn0004133,blow,2R,7580488,7587079,6591
FBgn0004132,boca,2R,7565873,7566738,865
FBgn0050499,Rpe,2R,7564434,7565751,1317
FBgn0033191,CG1598,2R,7538232,7539696,1464
FBgn0033188,Drat,2R,7526118,7532981,6863
FBgn0033186,CG1602,2R,7516923,7518936,2013
FBgn0003174,pwn,2R,7282572,7300806,18234
FBgn0033158,CG12164,2R,7311395,7313495,2100
FBgn0033160,Dhx15,2R,7387187,7391023,3836
FBgn0003460,so,2R,7419350,7434872,15522
FBgn0033169,CG11123,2R,7440706,7442885,2179
FBgn0033174,CG11125,2R,7447473,7449995,2522
FBgn0033178,CG11127,2R,7463504,7464987,1483
FBgn0033185,cliff,2R,7513846,7516390,2544
FBgn0025185,az2,2R,7510622,7512749,2127
FBgn0033184,mEFTu2,2R,7508527,7510357,1830
FBgn0015929,dpa,2R,7496702,7500145,3443
FBgn0033183,CG1620,2R,7493806,7496466,2660
FBgn0010548,Aldh-III,2R,7466879,7477162,10283
FBgn0033179,p47,2R,7465018,7466759,1741
FBgn0033177,CG11141,2R,7459685,7463395,3710
FBgn0050502,Fa2h,2R,7446189,7451553,5364
FBgn0040513,kappaB-Ras,2R,7443824,7445792,1968
FBgn0050503,CG30503,2R,7443824,7445792,1968
FBgn0033166,Eaf,2R,7396850,7407819,10969
FBgn0041243,Gr43a,2R,7390869,7393161,2292
FBgn0000352,cos,2R,7382176,7387115,4939
FBgn0033159,Dscam1,2R,7317924,7381899,63975
FBgn0033127,Tsp42Ef,2R,7025010,7028082,3072
FBgn0033128,Tsp42Eg,2R,7028911,7033233,4322
FBgn0033129,Tsp42Eh,2R,7033562,7034920,1358
FBgn0033130,Tsp42Ei,2R,7035125,7036949,1824
FBgn0033131,CR12842,2R,7039130,7039813,683
FBgn0033132,Tsp42Ej,2R,7040136,7042762,2626
FBgn0033133,Tsp42Ek,2R,7042656,7044710,2054
FBgn0033134,Tsp42El,2R,7045769,7048538,2769
FBgn0016032,lbm,2R,7049238,7051964,2726
FBgn0033135,Tsp42En,2R,7052747,7054399,1652
FBgn0033136,Tsp42Eo,2R,7054717,7056576,1859
FBgn0033139,Tsp42Er,2R,7064399,7066113,1714
FBgn0033140,CG12836,2R,7068572,7069896,1324
FBgn0024294,Spn43Aa,2R,7147692,7149289,1597
FBgn0003090,pk,2R,7150703,7223378,72675
FBgn0033149,CG11060,2R,7175886,7178290,2404
FBgn0053140,CG33140,2R,7178390,7180730,2340
FBgn0050384,CG30384,2R,7182997,7185298,2301
FBgn0033153,Gadd45,2R,7249161,7250655,1494
FBgn0026602,Adk3,2R,7243024,7245776,2752
FBgn0002930,nec,2R,7156477,7158241,1764
FBgn0044011,Spn43Ad,2R,7153738,7155424,1686
FBgn0015039,Cyp9b2,2R,7130277,7132139,1862
FBgn0015038,Cyp9b1,2R,7127838,7129808,1970
FBgn0033138,Tsp42Eq,2R,7062108,7063569,1461
FBgn0027558,Pgant3,2R,7057654,7061732,4078
FBgn0033137,Tsp42Ep,2R,7054405,7057548,3143
FBgn0016126,CaMKI,4,445504,453947,8443
FBgn0040324,Ephrin,4,571755,580122,8367
FBgn0039911,CG1909,4,583108,589348,6240
FBgn0024728,Slip1,4,663621,669884,6263
FBgn0039920,CG11360,4,671142,690650,19508
FBgn0026199,myo,4,690686,696055,5369
FBgn0039916,Ekar,4,636131,646556,10425
FBgn0028996,onecut,4,598555,607649,9094
FBgn0039909,ND-49,4,568296,571554,3258
FBgn0026869,Tdg,4,538332,557854,19522
FBgn0039908,Asator,4,469409,488994,19585
FBgn0026262,Taf3,4,459887,466828,6941
FBgn0039907,lgs,4,436957,443911,6954
FBgn0024811,Crk,4,210224,213165,2941
FBgn0039896,yellow-h,4,227922,230428,2506
FBgn0039897,CG1674,4,230730,245903,15173
FBgn0026777,Rad23,4,308093,310822,2729
FBgn0052850,Rnf11,4,314923,331387,16464
FBgn0039904,Hcf,4,359938,375554,15616
FBgn0039902,Zip102B,4,310930,314087,3157
FBgn0042696,NfI,4,268175,276369,8194
FBgn0053481,dpr7,4,247124,253329,6205
FBgn0051999,CG31999,4,215009,227748,12739
FBgn0051998,CG31998,4,196675,205945,9270
FBgn0039890,Abcd1,4,184076,193829,9753
FBgn0039889,Arl4,4,177348,179389,2041
FBgn0051997,CG31997,4,154654,156060,1406
FBgn0052006,CG32006,4,150764,153538,2774
FBgn0011747,Ank,4,115074,129849,14775
FBgn0017545,RpS3A,4,65225,67207,1982
FBgn0004859,ci,4,47710,57041,9331
FBgn0025740,PlexB,4,32478,43778,11300
FBgn0052009,CR32009,4,27020,31633,4613
FBgn0052010,CR32010,4,12640,25054,12414
FBgn0052011,CR32011,4,5829,11765,5936
FBgn0019985,mGluR,4,936819,949441,12622
FBgn0019650,toy,4,989725,1007922,18197
FBgn0010217,ATPsynbeta,4,1031484,1034917,3433
FBgn0013749,Arf4,4,1124167,1125325,1158
FBgn0002521,pho,4,1172469,1181628,9159
FBgn0052017,CG32017,4,1137830,1162158,24328
FBgn0039928,Cals,4,1112874,1123357,10483
FBgn0024913,Actbeta,4,1077331,1084796,7465
FBgn0011642,Zyx,4,1057365,1065001,7636
FBgn0039929,CG11076,4,1029711,1031757,2046
FBgn0039930,Mpv17,4,1028675,1029361,686
FBgn0039932,fuss,4,962341,978489,16148
FBgn0052016,4E-T,4,951542,958392,6850
FBgn0023213,eIF4G1,4,915297,930715,15418
FBgn0039936,Gyf,4,853557,867025,13468
FBgn0039937,fd102C,4,836986,844529,7543
FBgn0039938,Sox102F,4,800436,834393,33957
FBgn0039923,MED26,4,778516,788978,10462
FBgn0031208,CR11023,2L,7529,9484,1955
FBgn0024698,Cpsf160,2R,14497347,14503488,6141
FBgn0010473,tutl,2L,4283148,4323781,40633
FBgn0003386,Shaw,2L,3718185,3729145,10960
FBgn0051481,pb,3R,6707800,6742063,34263
FBgn0004577,Pxd,3R,17014576,17027987,13411
FBgn0010453,Wnt4,2L,7255419,7277171,21752
FBgn0010549,l(2)03659,2R,9390165,9395281,5116
FBgn0014342,mia,3R,5548115,5551168,3053
FBgn0032721,CG10602,2L,18855126,18859248,4122
FBgn0032720,mRpL13,2L,18858028,18859248,1220
FBgn0036290,CG10638,3L,12498106,12501311,3205
FBgn0002565,Lsp2,3L,12129393,12131869,2476
FBgn0036255,Atg12,3L,12136967,12137559,592
FBgn0017424,asRNA:CR11538,3L,12129103,12131488,2385
FBgn0025885,Inos,2R,7454922,7458874,3952
FBgn0014018,Rel,3R,9044183,9047977,3794
FBgn0038282,dpr9,3R,15054930,15077206,22276
FBgn0016047,nompA,2R,11310335,11318676,8341
FBgn0030151,CG1354,X,9778742,9782094,3352
FBgn0032851,CG13970,2L,20103386,20104150,764
FBgn0039817,CG15553,3R,31098868,31101169,2301
FBgn0003141,pr,2L,20073719,20075458,1739
FBgn0036039,Naa60,3L,9726895,9729650,2755
FBgn0038535,alt,3R,17673732,17682515,8783
FBgn0053503,Cyp12d1-d,2R,11123658,11125647,1989
FBgn0050489,Cyp12d1-p,2R,11117225,11121884,4659
FBgn0000109,Aprt,3L,1883795,1885019,1224
FBgn0039757,RpS7,3R,30206447,30209020,2573
FBgn0042173,CG18853,2R,7829062,7830429,1367
FBgn0003892,ptc,2R,8649649,8665223,15574
FBgn0005278,Sam-S,2L,106903,114432,7529
FBgn0052000,anne,4,132220,143123,10903
FBgn0021760,chb,3L,21172853,21183278,10425
FBgn0036640,nxf2,3L,16576859,16580306,3447
FBgn0067783,DPCoAC,3R,20552385,20557667,5282
FBgn0035981,CG4452,3L,9367377,9370300,2923
FBgn0001098,Gdh,3R,23935958,23943101,7143
FBgn0002174,CG5504,2R,23706913,23709026,2113
FBgn0017418,ari-1,X,18130392,18137784,7392
FBgn0002921,Atpalpha,3R,20948714,20976239,27525
FBgn0000083,AnxB9,3R,21065241,21070917,5676
FBgn0011672,Mvl,3R,21051383,21060800,9417
FBgn0036414,,3L,14186249,14189648,3399
FBgn0036544,sff,3L,15900156,15924861,24705
FBgn0034274,CG10931,2R,17748935,17750136,1201
FBgn0034275,CG5002,2R,17750293,17753214,2921
FBgn0027572,Acox1,2R,17760940,17764541,3601
FBgn0026309,aft,2R,17786135,17788556,2421
FBgn0028744,CG5033,2R,17789679,17792448,2769
FBgn0028743,Dhit,2R,17792870,17800677,7807
FBgn0026316,Ubc10,2R,17788412,17789410,998
FBgn0028740,CG6362,2R,17770405,17772552,2147
FBgn0034279,CG18635,2R,17767808,17769989,2181
FBgn0034277,OstDelta,2R,17764574,17767070,2496
FBgn0034276,Sardh,2R,17753555,17756422,2867
FBgn0035917,Zasp66,3L,8624371,8638813,14442
FBgn0036101,NijA,3L,10694360,10696877,2517
FBgn0032388,CG6686,2L,11984327,11988039,3712
FBgn0030887,CG6867,X,18023870,18028261,4391
FBgn0030892,Swt1,X,18088725,18090509,1784
FBgn0020429,GluRIIB,2L,5559342,5563502,4160
FBgn0036790,AstC-R1,3L,18560258,18576326,16068
FBgn0036689,CG7730,3L,17027515,17029814,2299
FBgn0010424,TpnC73F,3L,17046063,17048390,2327
FBgn0036911,Fibp,3L,19816085,19817967,1882
FBgn0036900,CG8765,3L,19683941,19687353,3412
FBgn0015721,ktub,2R,21101928,21123704,21776
FBgn0053493,CG33493,3L,10692530,10693167,637
FBgn0053494,CG33494,3R,25493481,25495161,1680
FBgn0040227,eIF3d1,3R,23680039,23682317,2278
FBgn0025790,TBPH,2R,23859067,23862593,3526
FBgn0032699,CG10383,2L,18690904,18695602,4698
FBgn0036302,sowah,3L,12537513,12572542,35029
FBgn0016034,mael,3L,22721203,22726234,5031
FBgn0031883,Caper,2L,7032721,7037878,5157
FBgn0031835,Dpp10,2L,6568400,6601068,32668
FBgn0031115,CG11710,X,20427411,20429673,2262
FBgn0039313,CG11892,3R,25281548,25283237,1689
FBgn0000286,Cf2,2L,4876891,4883107,6216
FBgn0028425,JhI-21,2L,12051755,12056042,4287
FBgn0003380,Sh,X,17924307,18063247,138940
FBgn0037153,olf413,3L,22136090,22247702,111612
FBgn0038448,CG12783,3R,16611419,16613400,1981
FBgn0061197,salto,2R,12302544,12306269,3725
FBgn0027780,Aasdh,2L,8445861,8449576,3715
FBgn0028560,sut4,2R,10085442,10087127,1685
FBgn0003464,sol,X,21350280,21357912,7632
FBgn0023023,CRMP,3R,5571108,5579189,8081
FBgn0037222,CG14642,3R,4241045,4242717,1672
FBgn0037836,CG14692,3R,10794058,10803955,9897
FBgn0029588,CR14798,X,1692824,1693843,1019
FBgn0020371,Tim17b2,2L,15484729,15485545,816
FBgn0030657,cerv,X,15576986,15578171,1185
FBgn0043070,MESK2,2R,21502097,21517241,15144
FBgn0029941,CG1677,X,7281089,7405797,124708
FBgn0036574,elg1,3L,16132028,16136691,4663
FBgn0003118,pnt,3R,23290231,23346167,55936
FBgn0004595,pros,3R,11328480,11407627,79147
FBgn0016038,Vsp37A,X,621530,623051,1521
FBgn0033566,CG18004,2R,10885019,10886375,1356
FBgn0036646,CR18217,3L,16600448,16602723,2275
FBgn0033285,CG18449,2R,8367163,8367927,764
FBgn0003189,r,X,16655359,16668712,13353
FBgn0032202,REPTOR-BP,2L,10264125,10265229,1104
FBgn0002773,Mlc2,3R,30171438,30174551,3113
FBgn0031450,Hrs,2L,2739986,2743377,3391
FBgn0050011,gem,2R,10124293,10137472,13179
FBgn0050159,CG30159,2R,6992681,6994306,1625
FBgn0050423,CG30423,2R,24874976,24875865,889
FBgn0038194,Cyp6d5,3R,14029228,14031483,2255
FBgn0051665,wry,2L,1836538,1858550,22012
FBgn0051720,mthl15,2L,10234585,10238317,3732
FBgn0005666,bt,4,724400,776474,52074
FBgn0052206,CG32206,3L,19340321,19412912,72591
FBgn0052442,Arv1,3L,21528218,21529333,1115
FBgn0052495,Gss2,X,17899702,17906025,6323
FBgn0052656,Muc11A,X,12059795,12065144,5349
FBgn0031518,CG3277,2L,3304100,3317418,13318
FBgn0023531,CG32809,X,1673110,1692768,19658
FBgn0053170,CG33170,3L,22864600,22867535,2935
FBgn0053198,pen-2,2R,18277439,18278762,1323
FBgn0035802,Pura,3L,7593091,7639573,46482
FBgn0032120,CG33298,2L,9495474,9520696,25222
FBgn0041723,rho-5,2L,10368025,10373900,5875
FBgn0053318,CR33318,2L,20923955,20924534,579
FBgn0052311,zormin,3L,2117466,2151700,34234
FBgn0003016,osp,2L,14599196,14689340,90144
FBgn0035028,Start1,2R,24574559,24577676,3117
FBgn0015925,csul,2R,16264652,16266959,2307
FBgn0013305,Nmda1,2R,12877094,12880230,3136
FBgn0021761,Nup154,2L,11004820,11010921,6101
FBgn0038474,mRpS11,3R,17072732,17073795,1063
FBgn0025456,CREG,3R,17393272,17394640,1368
FBgn0026379,Pten,2L,10256319,10261049,4730
FBgn0039207,Cftr,3R,24536204,24543914,7710
FBgn0032455,Pih1D1,2L,12713276,12721843,8567
FBgn0039215,CG6695,3R,24655160,24659379,4219
FBgn0039714,Zip99C,3R,29863701,29868895,5194
FBgn0039711,CG7824,3R,29857652,29858936,1284
FBgn0002567,Rab32,2R,9177864,9186342,8478
FBgn0032001,CG8360,2L,8212959,8214135,1176
FBgn0031548,CG8852,2L,3525131,3527588,2457
FBgn0025682,scf,3L,1298672,1300389,1717
FBgn0031778,lncRNA:CR9162,2L,6078453,6079736,1283
FBgn0032907,Nthl1,2L,20926319,20927860,1541
FBgn0031813,Acox3,2L,6426724,6448403,21679
FBgn0026620,tacc,3R,4733654,4749056,15402
FBgn0003721,Tm1,3R,15278220,15308779,30559
FBgn0034405,Jheh2,2R,18855767,18858245,2478
FBgn0039915,Gat,4,629691,635350,5659
FBgn0020445,E23,2L,3334875,3354829,19954
FBgn0004509,Fur1,3R,25347431,25473058,125627
FBgn0000117,arm,X,1891401,1900646,9245
FBgn0022361,Pur-alpha,4,558016,567257,9241
FBgn0023175,Prosalpha7,2R,9846636,9847836,1200
FBgn0010329,Tbh,X,7995697,8027394,31697
FBgn0011754,PhKgamma,X,11695137,11704394,9257
FBgn0001991,Ca-alpha1D,2L,16165831,16190540,24709
FBgn0032456,MRP,2L,12719045,12766546,47501
FBgn0067782,att-ORFB,3R,20552635,20554400,1765
FBgn0027934,alpha-Est4aPsi,3R,7526369,7528068,1699
FBgn0034053,Cyp4aa1,2R,15942864,15947266,4402
FBgn0034054,CG8366,2R,15955040,15956636,1596
FBgn0050069,Sdb,2R,14185204,14198368,13164
FBgn0039114,Lsd-1,3R,23763857,23766662,2805
FBgn0039116,CG10375,3R,23767712,23768984,1272
FBgn0015513,mbc,3R,23781765,23801634,19869
FBgn0039120,Nup98-96,3R,23774225,23781621,7396
FBgn0039118,CG10208,3R,23772998,23774127,1129
FBgn0039117,tst,3R,23768399,23772859,4460
FBgn0039115,CG10214,3R,23766519,23767488,969
FBgn0039113,udt,3R,23760737,23763263,2526
FBgn0035477,CG14982,3L,3942710,3947278,4568
FBgn0004880,scrt,3L,3983896,3994003,10107
FBgn0035482,CG14985,3L,4003474,4006626,3152
FBgn0035483,Mul1,3L,4021457,4023501,2044
FBgn0045479,Gr64a,3L,4026769,4028600,1831
FBgn0045478,Gr64b,3L,4028605,4032032,3427
FBgn0045477,Gr64c,3L,4028605,4032032,3427
FBgn0052255,Gr64f,3L,4035799,4037575,1776
FBgn0035484,CG11594,3L,4022700,4026011,3311
FBgn0035481,CG12605,3L,3954251,3964771,10520
FBgn0035480,CG14984,3L,3951193,3952550,1357
FBgn0027552,CG10863,3L,3941008,3942465,1457
FBgn0035476,CG12766,3L,3938624,3940125,1501
FBgn0035475,CG10866,3L,3936060,3937992,1932
FBgn0030545,CG11590,X,14200178,14200907,729
FBgn0026713,Prp16,X,14201362,14224732,23370
FBgn0030552,mRpL38,X,14226289,14227949,1660
FBgn0030554,Dus2,X,14237988,14240152,2164
FBgn0260482,CG32599,X,14243686,14246514,2828
FBgn0030558,Tat,X,14261223,14265379,4156
FBgn0002917,na,X,14266367,14277416,11049
FBgn0030562,CG9400,X,14288084,14289393,1309
FBgn0030559,CG13404,X,14264737,14266250,1513
FBgn0030556,mRNA-cap,X,14240266,14242822,2556
FBgn0030555,Fbxl4,X,14234413,14237923,3510
FBgn0030551,CG11674,X,14224647,14225879,1232
FBgn0040153,l(1)G0469,X,14203961,14211457,7496
FBgn0003053,peb,X,4617564,4627206,9642
FBgn0025739,pon,X,4636318,4639112,2794
FBgn0029718,mRpL30,X,4647871,4648646,775
FBgn0022942,Cbp80,X,4650015,4658259,8244
FBgn0029720,CG3009,X,4658158,4666700,8542
FBgn0029719,CG15473,X,4651955,4654497,2542
FBgn0025615,Torsin,X,4648592,4650032,1440
FBgn0011277,HLH4C,X,4645127,4647414,2287
FBgn0025613,CG3081,X,4639259,4643987,4728
FBgn0023395,Chd3,3L,19447173,19450238,3065
FBgn0052212,CG32212,3L,19487560,19488348,788
FBgn0036879,Cpr76Bb,3L,19519649,19520419,770
FBgn0036877,CG9452,3L,19501010,19503870,2860
FBgn0036876,CG9451,3L,19498197,19500798,2601
FBgn0036875,CG9449,3L,19492053,19497723,5670
FBgn0052207,hpRNA:CR32207,3L,19477329,19478720,1391
FBgn0053062,CG33062,3L,19441719,19446444,4725
FBgn0031126,Cyp6v1,X,20657122,20661425,4303
FBgn0031127,CG1835,X,20661917,20669669,7752
FBgn0031128,hydra,X,20670832,20677063,6231
FBgn0019929,Ser7,X,9865233,9867070,1837
FBgn0030157,CG1468,X,9878422,9879279,857
FBgn0030158,CG9686,X,9879870,9880535,665
FBgn0030159,CG9689,X,9881953,9883670,1717
FBgn0030160,CG9691,X,9884442,9885044,602
FBgn0030156,CG15247,X,9874493,9876672,2179
FBgn0052695,CG32695,X,9872382,9874057,1675
FBgn0024807,DIP1,X,21624796,21630148,5352
FBgn0053502,CG33502,X,21609357,21611526,2169
FBgn0052819,CG32819,X,21617889,21621104,3215
FBgn0040028,CG17450,X,21605884,21608920,3036
FBgn0052820,CG32820,X,21611797,21615239,3442
FBgn0027588,GCS2alpha,X,21600502,21605264,4762
FBgn0052230,ND-MLRQ,3L,23339326,23345936,6610
FBgn0010215,alpha-Cat,3L,23318646,23338100,19454
FBgn0039530,Tusp,3R,27607879,27634932,27053
FBgn0039532,Mtl,3R,27636412,27639871,3459
FBgn0027494,RpS10a,3R,27652760,27653363,603
FBgn0039536,unc80,3R,27662439,27677099,14660
FBgn0039537,Hsdl2,3R,27677522,27679013,1491
FBgn0039538,CG12883,3R,27679291,27680336,1045
FBgn0046258,CG12880,3R,27685962,27692790,6828
FBgn0045862,btz,3R,27700361,27703445,3084
FBgn0039543,CROT,3R,27703379,27706751,3372
FBgn0051055,CG31055,3R,27685632,27688134,2502
FBgn0003330,Sce,3R,27680431,27682029,1598
FBgn0002772,Mlc1,3R,27657078,27660177,3099
FBgn0039531,CG5611,3R,27634625,27636060,1435
FBgn0039529,CG5612,3R,27623359,27626011,2652
FBgn0260484,HIP,X,3799150,3801570,2420
FBgn0021738,Crg-1,X,3793223,3797339,4116
FBgn0029679,CG2901,X,3828197,3831546,3349
FBgn0031644,CG15625,2L,4889995,4891277,1282
FBgn0031645,CG3036,2L,4892112,4903889,11777
FBgn0003372,Sgs1,2L,4937409,4941423,4014
FBgn0031650,synr,2L,4942742,4944305,1563
FBgn0039331,ND-49L,3R,25358285,25360034,1749
FBgn0039332,alrm,3R,25381065,25382781,1716
FBgn0032859,Arpc2,2L,20417057,20423027,5970
FBgn0051687,CG31687,2L,20450225,20456978,6753
FBgn0032863,Cdc23,2L,20459342,20461729,2387
FBgn0032864,CG2493,2L,20461585,20463444,1859
FBgn0042175,CG18858,2L,20456847,20459075,2228
FBgn0051683,CG31683,2L,20447734,20449964,2230
FBgn0032860,CG15130,2L,20423106,20424660,1554
FBgn0032858,CG10949,2L,20415173,20416918,1745
FBgn0031688,Cyp28d2,2L,5207267,5209345,2078
FBgn0031692,TpnC25D,2L,5216701,5219053,2352
FBgn0031690,CG7742,2L,5212395,5215081,2686
FBgn0033538,CG11883,2R,10617662,10641807,24145
FBgn0033540,Elp2,2R,10645735,10648634,2899
FBgn0033541,CG12934,2R,10648888,10649830,942
FBgn0033539,Git,2R,10641818,10645427,3609
FBgn0031195,CG17600,X,22515197,22542024,26827
FBgn0031196,Cluap1,X,22542386,22544322,1936
FBgn0031194,CG17598,X,22534831,22540383,5552
FBgn0010316,dap,2R,9712321,9716256,3935
FBgn0033633,Smyd4-3,2R,11405597,11408079,2482
FBgn0040503,CG7763,2R,11414510,11415462,952
FBgn0015872,Drip,2R,11411203,11429645,18442
FBgn0050026,CG30026,2R,11408576,11409449,873
FBgn0033015,d4,2R,5259004,5295965,36961
FBgn0033019,CG10395,2R,5350477,5351972,1495
FBgn0033020,COX4L,2R,5353994,5354723,729
FBgn0033021,CG10417,2R,5360331,5363104,2773
FBgn0050441,IFT20,2R,5351717,5352122,405
FBgn0033017,CG10465,2R,5339706,5340995,1289
FBgn0052133,Ptip,3L,14020315,14029121,8806
FBgn0053196,dpy,2L,4477462,4614300,136838
FBgn0040849,Ir41a,2R,4917519,5021955,104436
FBgn0033005,CG3107,2R,5090581,5095090,4509
FBgn0033010,Atf6,2R,5144733,5154756,10023
FBgn0026238,gus,2R,5116990,5128321,11331
FBgn0013348,TpnC41C,2R,5065237,5070210,4973
FBgn0032949,Lamp1,2L,21573389,21577103,3714
FBgn0030715,Or13a,X,15974425,15976706,2281
FBgn0030717,Slc25A46a,X,15983772,15985405,1633
FBgn0000611,exd,X,15992468,15996509,4041
FBgn0030720,CG8939,X,15997016,15999698,2682
FBgn0030721,CG12698,X,16006147,16008721,2574
FBgn0030723,dpr18,X,16063738,16070304,6566
FBgn0030725,CG8958,X,16083232,16085751,2519
FBgn0028397,Tob,X,16074717,16091495,16778
FBgn0030724,Nipsnap,X,16070365,16073568,3203
FBgn0003969,vap,X,15999951,16005812,5861
FBgn0030719,eIF5,X,15987008,15991974,4966
FBgn0030718,ND-20,X,15985473,15986808,1335
FBgn0030716,Cep164,X,15977967,15982944,4977
FBgn0029174,Fkbp59,2L,9888005,9890119,2114
FBgn0032153,CG4537,2L,9890885,9891336,451
FBgn0010520,Bka,2L,9895287,9896104,817
FBgn0024285,Srp54,2L,9912911,9915044,2133
FBgn0040064,yip2,2L,9915253,9917220,1967
FBgn0032160,CG4598,2L,9918618,9920120,1502
FBgn0032161,CG4594,2L,9920160,9921459,1299
FBgn0032162,CG4592,2L,9921633,9922860,1227
FBgn0032166,CG4619,2L,9938863,9943058,4195
FBgn0032167,CG5853,2L,9940773,9947648,6875
FBgn0051712,Arglu1,2L,9934767,9938134,3367
FBgn0032163,TbCMF46,2L,9922737,9924865,2128
FBgn0025700,CG5885,2L,9917221,9918330,1109
FBgn0032156,CG13124,2L,9903279,9908633,5354
FBgn0053300,Muc30E,2L,9897820,9903128,5308
FBgn0004867,RpS2,2L,9896265,9897552,1287
FBgn0032154,mtDNA-helicase,2L,9891255,9893446,2191
FBgn0031089,aspr,X,20148124,20155514,7390
FBgn0031092,CG9577,X,20166673,20168080,1407
FBgn0031094,CG9578,X,20170222,20171526,1304
FBgn0031097,obst-A,X,20239855,20243209,3354
FBgn0022770,Peritrophin-A,X,20244647,20248203,3556
FBgn0015789,Rab10,X,20251338,20254691,3353
FBgn0031099,CG17065,X,20254692,20257199,2507
FBgn0031098,CG17068,X,20248309,20251093,2784
FBgn0003654,sw,X,20227961,20236382,8421
FBgn0053498,CR33498,X,20225137,20226111,974
FBgn0053499,Sdic4,X,20220666,20225020,4354
FBgn0053487,CR33487,X,20194360,20195360,1000
FBgn0052823,Sdic3,X,20189440,20194227,4787
FBgn0053496,CR33496,X,20186630,20187604,974
FBgn0053497,Sdic2,X,20181590,20186487,4897
FBgn0053491,CR33491,X,20178755,20179729,974
FBgn0067861,Sdic1,X,20174217,20178638,4421
FBgn0000084,AnxB10,X,20171445,20173514,2069
FBgn0031093,CG9581,X,20168042,20169981,1939
FBgn0031091,Phf7,X,20160355,20165830,5475
FBgn0031090,Rab35,X,20155766,20159872,4106
FBgn0030759,CG13014,X,16587873,16588930,1057
FBgn0061200,Nup153,X,16599241,16610459,11218
FBgn0025743,mbt,X,16610685,16614856,4171
FBgn0030764,CG9777,X,16630673,16632235,1562
FBgn0030763,CG9782,X,16615028,16621589,6561
FBgn0030761,CG9784,X,16595136,16599215,4079
FBgn0015615,SMC3,X,16588996,16593439,4443
FBgn0011826,Pp2B-14D,X,16554627,16560016,5389
FBgn0011742,Arp2,X,16548290,16553968,5678
FBgn0030757,CG9902,X,16542124,16547520,5396
FBgn0030756,CG9903,X,16539153,16540852,1699
FBgn0040775,CG12158,2R,9362574,9362906,332
FBgn0041150,hoe1,2L,4908581,4932384,23803
FBgn0033403,CG13739,2R,9309296,9351655,42359
FBgn0033250,CG14762,2R,8009119,8013755,4636
FBgn0034072,Dg,2R,16081176,16098564,17388
FBgn0033155,Br140,2R,7272275,7278101,5826
FBgn0025360,Optix,2R,8031283,8042529,11246
FBgn0033154,CG1850,2R,7258867,7261269,2402
FBgn0031646,snsl,2L,4903865,4906762,2897
FBgn0015000,betaggt-I,2L,4945579,4948324,2745
FBgn0031655,Marcal1,2L,4955509,4958292,2783
FBgn0031657,Polr1C,2L,4969004,4970216,1212
FBgn0031662,CG3792,2L,4977312,4978567,1255
FBgn0033911,VGAT,2R,14198478,14201249,2771
FBgn0034071,CG8405,2R,16047648,16060835,13187
FBgn0034479,CG8654,2R,19979242,19984895,5653
FBgn0031651,mRpL24,2L,4944256,4945361,1105
FBgn0031653,Jon25Biii,2L,4949941,4950767,826
FBgn0031652,jet,2L,4948206,4949784,1578
FBgn0015834,eIF3i,2L,4966367,4967775,1408
FBgn0031661,Gmd,2L,4975300,4977023,1723
FBgn0031663,CG8891,2L,4978484,4979379,895
FBgn0031664,CG8892,2L,4979513,4981592,2079
FBgn0031659,CG14043,2L,4971702,4973687,1985
FBgn0037028,CG3618,3L,20813353,20816075,2722
FBgn0031660,mRpL28,2L,4973976,4975316,1340
FBgn0061515,endos,3L,14029579,14031706,2127
FBgn0052580,Muc14A,X,16009114,16061722,52608
FBgn0051961,Tbcc,2L,4186250,4187793,1543
FBgn0053505,U3-55K,2R,14858845,14860758,1913
FBgn0053506,CG33506,2R,14857447,14858640,1193
FBgn0053508,ppk13,2L,21086790,21088751,1961
FBgn0053509,CG33509,2L,21084605,21086506,1901
FBgn0053510,CG33510,2L,21082643,21084326,1683
FBgn0053511,CG33511,2L,21081127,21082494,1367
FBgn0053512,dpr4,3R,11533483,11542949,9466
FBgn0053513,Nmdar2,X,1483625,1507809,24184
FBgn0053514,CG33514,3L,4365434,4366671,1237
FBgn0053516,dpr3,2L,2058790,2109878,51088
FBgn0053519,Obsc,2R,23995543,24014254,18711
FBgn0053523,CG33523,3L,5923862,5930120,6258
FBgn0053527,SIFa,2R,24577566,24578143,577
FBgn0053530,Acp53C14c,2R,16750776,16751495,719
FBgn0053531,Ddr,2L,6253123,6323466,70343
FBgn0053542,upd3,X,18277233,18284596,7363
FBgn0053543,CG33543,2L,1997102,2006313,9211
FBgn0053526,PNUTS,2L,870465,877038,6573
FBgn0053547,Rim,3R,17872748,17916578,43830
FBgn0053504,snRNA:U7,3L,3593823,3593893,70
FBgn0053539,tRNA:Trp-CCA-2-5,2R,21181284,21181355,71
FBgn0002183,dre4,3L,1871574,1876312,4738
FBgn0030018,slpr,X,8170229,8177185,6956
FBgn0010263,Rbp9,2L,2954762,2968434,13672
FBgn0052484,Sk2,3L,3047087,3050159,3072
FBgn0004648,svr,X,496446,509072,12626
FBgn0020493,Dad,3R,17054007,17070408,16401
FBgn0029723,Proc-R,X,4707916,4729487,21571
FBgn0001301,kel,2L,18129884,18138083,8199
FBgn0035331,MsR1,3L,2322693,2345799,23106
FBgn0031689,Cyp28d1,2L,5210460,5212445,1985
FBgn0053548,SmydA-8,X,2205515,2213809,8294
FBgn0040726,dpr1,2R,20698483,20750442,51959
FBgn0053554,Nipped-A,2R,5177965,5251022,73057
FBgn0029518,CG13376,X,265724,267028,1304
FBgn0053556,form3,3L,7094818,7123297,28479
FBgn0000575,emc,3L,749400,753492,4092
FBgn0038087,beat-Va,3R,12840560,12848419,7859
FBgn0010317,CycJ,3L,3466428,3468098,1670
FBgn0003231,ref(2)P,2L,19542468,19545548,3080
FBgn0000625,eyg,3L,12462537,12468021,5484
FBgn0003984,vn,3L,5813338,5845664,32326
FBgn0010894,sinu,3L,5559470,5561598,2128
FBgn0003429,slo,3R,24662491,24711595,49104
FBgn0004587,B52,3R,13661311,13666891,5580
FBgn0004882,orb,3R,23260610,23280856,20246
FBgn0005561,sv,4,1088798,1113317,24519
FBgn0033170,sPLA2,2R,7442864,7443827,963
FBgn0039927,CG11155,4,1126602,1137919,11317
FBgn0027339,jim,3L,22789233,22835194,45961
FBgn0034990,CG11406,2R,24202091,24208203,6112
FBgn0041164,armi,3L,3461317,3466314,4997
FBgn0037313,CG1161,3R,5355092,5356748,1656
FBgn0041707,7B2,3R,5376780,5377975,1195
FBgn0002774,mle,2R,5974857,5980778,5921
FBgn0002873,mud,X,14247732,14258595,10863
FBgn0004102,oc,X,8630159,8650681,20522
FBgn0033807,AQP,2R,13212405,13214496,2091
FBgn0003124,polo,3L,20309654,20313466,3812
FBgn0000303,ChAT,3R,18705501,18732344,26843
FBgn0002440,l(3)mbn,3L,6123934,6128807,4873
FBgn0041242,Gr47a,2R,10362185,10363584,1399
FBgn0004606,zfh1,3R,30765926,30789202,23276
FBgn0033195,CG1360,2R,7587773,7590109,2336
FBgn0028572,qtc,2L,5060815,5070750,9935
FBgn0038651,Epg5,3R,18750436,18758873,8437
FBgn0004607,zfh2,4,501810,540874,39064
FBgn0005558,ey,4,697689,721173,23484
FBgn0037317,CG14667,3R,5375022,5376460,1438
FBgn0003950,unc,X,21111414,21116914,5500
FBgn0023416,Ac3,2L,21632587,21647964,15377
FBgn0000259,CkIIbeta,X,11792533,11801587,9054
FBgn0003741,tra,3L,16590059,16591050,991
FBgn0040097,lectin-30A,2L,9254076,9254854,778
FBgn0028841,jhamt,2L,16365903,16367039,1136
FBgn0000241,bw,2R,23527805,23538499,10694
FBgn0004907,14-3-3zeta,2R,10099677,10109687,10010
FBgn0039914,mav,4,623219,626031,2812
FBgn0019828,dj,3R,7059315,7060524,1209
FBgn0004369,Ptp99A,3R,29377646,29487131,109485
FBgn0010114,hig,2R,9227785,9247249,19464
FBgn0029676,HIP-R,X,3789969,3792477,2508
FBgn0026059,Mhcl,3R,16068523,16098761,30238
FBgn0005427,ewg,X,268509,279718,11209
FBgn0051439,Muc96D,3R,25397788,25400645,2857
FBgn0000053,Gart,2L,7014623,7023898,9275
FBgn0000567,Eip74EF,3L,17558672,17619325,60653
FBgn0052333,CG32333,3L,1275956,1295699,19743
FBgn0041605,cpx,3R,4280221,4304604,24383
FBgn0052576,CG32576,X,16285953,16288533,2580
FBgn0052602,Muc12Ea,X,14277735,14288161,10426
FBgn0053111,CG33111,3R,23801714,23819237,17523
FBgn0039396,CCAP-R,3R,25923499,25956270,32771
FBgn0053558,mim,2R,6924687,6971637,46950
FBgn0001148,gsb,2R,25061964,25064643,2679
FBgn0014141,cher,3R,17091533,17125389,33856
FBgn0010382,CycE,2L,15727581,15748150,20569
FBgn0004575,Syn,3R,10190689,10222442,31753
FBgn0000042,Act5C,X,5900861,5905399,4538
FBgn0034976,CG4049,2R,24107087,24114292,7205
FBgn0034982,Naa35,2R,24135180,24138050,2870
FBgn0020385,pug,3R,10696534,10703316,6782
FBgn0037822,CG14683,3R,10696647,10698976,2329
FBgn0038295,Gyc88E,3R,15150375,15191242,40867
FBgn0004227,nonA,X,16361569,16371547,9978
FBgn0015546,spel1,2L,14362069,14366840,4771
FBgn0016917,Stat92E,3R,20535323,20552311,16988
FBgn0032117,FucTB,2L,9428669,9431052,2383
FBgn0014135,bnl,3R,19794073,19836817,42744
FBgn0033809,CG4630,2R,13215659,13219247,3588
FBgn0033810,CG4646,2R,13219396,13220251,855
FBgn0035964,Dhpr,3L,9134560,9135916,1356
FBgn0039348,Npl4,3R,25611013,25624662,13649
FBgn0039349,Ssadh,3R,25624805,25626924,2119
FBgn0002789,Mp20,2R,13246670,13248880,2210
FBgn0037719,bocks,3R,9589468,9591002,1534
FBgn0027375,RecQ5,3L,14628160,14632077,3917
FBgn0005677,dac,2L,16466512,16485998,19486
FBgn0035956,Doc2,3L,9012686,9019246,6560
FBgn0038950,CG5382,3R,22364573,22365983,1410
FBgn0011225,jar,3R,24252826,24271233,18407
FBgn0003701,thr,2R,17861273,17865963,4690
FBgn0038872,Nelf-A,3R,21223704,21229512,5808
FBgn0036180,Duba,3L,11605436,11609465,4029
FBgn0004924,Top1,X,15319479,15328029,8550
FBgn0004903,Rb97D,3R,26872129,26875742,3613
FBgn0001168,hry,3L,8675759,8679253,3494
FBgn0032369,CG6614,2L,11644619,11648839,4220
FBgn0000008,a,2R,22136968,22172834,35866
FBgn0000261,Cat,3L,18822604,18828188,5584
FBgn0004169,up,X,13593474,13602578,9104
FBgn0023076,Clk,3L,7763233,7775603,12370
FBgn0001208,Hn,3L,7760453,7763166,2713
FBgn0036165,chrb,3L,11487550,11499055,11505
FBgn0020496,CtBP,3R,13011649,13026275,14626
FBgn0027841,CstF64,3R,18659618,18661126,1508
FBgn0039713,RpS8,3R,29861582,29863902,2320
FBgn0039738,Mgat2,3R,30015513,30022221,6708
FBgn0015269,Nf1,3R,25983013,25995737,12724
FBgn0037746,CG8478,3R,9763650,9766135,2485
FBgn0037747,Naa80,3R,9767834,9770027,2193
FBgn0003862,trx,3R,14263358,14286903,23545
FBgn0010226,GstS1,2R,17093246,17099501,6255
FBgn0000577,en,2R,11524006,11528210,4204
FBgn0000028,acj6,X,15350239,15379064,28825
FBgn0022710,Ac13E,X,15510877,15554278,43401
FBgn0012034,AcCoAS,3L,21270722,21280243,9521
FBgn0027866,CG9776,3R,4327814,4334071,6257
FBgn0038201,PK1-R,3R,14099832,14103122,3290
FBgn0045500,Gr22b,2L,1792057,1793268,1211
FBgn0000721,for,2L,3622074,3656953,34879
FBgn0034420,CG10737,2R,19164143,19178223,14080
FBgn0003218,rdgB,X,13762752,13779488,16736
FBgn0024836,stan,2R,10673345,10721138,47793
FBgn0031016,kek5,X,19353181,19471914,118733
FBgn0034416,CG15109,2R,19059421,19061065,1644
FBgn0025936,Eph,4,610684,622470,11786
FBgn0000578,ena,2R,19141632,19163705,22073
FBgn0031649,hoe2,2L,4933047,4936450,3403
FBgn0032668,CG17681,2L,18153123,18154516,1393
FBgn0041210,HDAC4,X,13262687,13285632,22945
FBgn0001269,inv,2R,11474465,11509695,35230
FBgn0027608,CG2082,3R,5758680,5781076,22396
FBgn0039900,Syt7,4,278685,306481,27796
FBgn0031474,CG2991,2L,2857164,2868548,11384
FBgn0025726,unc-13,4,867824,912331,44507
FBgn0051721,Trim9,2L,10544883,10628054,83171
FBgn0051992,gw,4,649041,660608,11567
FBgn0028341,Ptpmeg2,X,9626294,9659145,32851
FBgn0032974,CG3651,2L,22121338,22126614,5276
FBgn0029870,Marf,X,6365949,6370924,4975
FBgn0035001,Slik,2R,24392129,24402680,10551
FBgn0032666,CG5758,2L,18119995,18129862,9867
FBgn0026533,Dek,2R,16856220,16861738,5518
FBgn0036534,DCP2,3L,15818734,15826423,7689
FBgn0036144,GlcAT-P,3L,11176954,11197536,20582
FBgn0033265,coil,2R,8124981,8127242,2261
FBgn0038139,PK2-R2,3R,13329070,13334166,5096
FBgn0027529,tapas,2R,20319180,20325973,6793
FBgn0031802,ppk7,2L,6352324,6354331,2007
FBgn0037234,CG9795,3R,4319683,4326379,6696
FBgn0030641,CG6299,X,15462722,15466812,4090
FBgn0029736,CG4041,X,4915280,4918447,3167
FBgn0030662,Chsy,X,15585289,15593534,8245
FBgn0035978,UGP,3L,9350867,9358935,8068
FBgn0031530,Pgant2,2L,3404460,3426719,22259
FBgn0037100,CapaR,3L,21558974,21562181,3207
FBgn0032957,CG2225,2L,21663806,21677530,13724
FBgn0034417,CG15117,2R,19122231,19129300,7069
FBgn0031294,IA-2,2L,1008378,1048053,39675
FBgn0000542,ec,X,3811698,3857621,45923
FBgn0050372,Asap,2R,8114286,8123001,8715
FBgn0030844,ppk23,X,17566552,17569228,2676
FBgn0031536,Cog3,2L,3453697,3457064,3367
FBgn0039675,ppk21,3R,29664779,29666783,2004
FBgn0039676,ppk20,3R,29666814,29668877,2063
FBgn0020279,lig,2R,8067977,8078815,10838
FBgn0015777,nrv2,2L,6789770,6798862,9092
FBgn0052547,CG32547,X,18443027,18479487,36460
FBgn0037560,CR18228,3R,8260706,8261898,1192
FBgn0029105,alpha-Catr,2R,23957842,23961631,3789
FBgn0038570,Prx5,3R,18165442,18167273,1831
FBgn0038571,CG7215,3R,18165442,18167273,1831
FBgn0039308,CG11889,3R,25270209,25273267,3058
FBgn0039309,CG11891,3R,25270209,25273267,3058
FBgn0036170,CG11714,3L,11518798,11522713,3915
FBgn0031039,Shawn,X,19611526,19615617,4091
FBgn0031038,Tyler,X,19611526,19615617,4091
FBgn0053155,CG33155,2R,13954195,13955664,1469
FBgn0050481,mRpL53,2R,13954195,13955664,1469
FBgn0013576,mtd,3R,5270116,5350443,80327
FBgn0043002,Chrac-14,2L,8437405,8437996,591
FBgn0002887,mus201,2L,8438169,8442342,4173
FBgn0053095,CG33095,3R,25097672,25102146,4474
FBgn0053267,CG33267,3L,11564483,11572796,8313
FBgn0065047,snoRNA:U3:54Ab,2R,17145617,17145826,209
FBgn0032538,Vajk2,2L,13932559,13934692,2133
FBgn0065080,snoRNA:Me18S-A1374,3R,19586196,19586263,67
FBgn0065070,snoRNA:291,3R,28812568,28812641,73
FBgn0053639,CG33639,X,18210812,18226076,15264
FBgn0029948,CheA7a,X,7378140,7378953,813
FBgn0053640,CG33640,2L,13527841,13528537,696
FBgn0053641,CG33641,2L,13529042,13529821,779
FBgn0035253,Srrm234,3L,1654247,1665064,10817
FBgn0053647,CG33647,3L,19236360,19237057,697
FBgn0053648,CG33648,2L,14524312,14525656,1344
FBgn0064115,GatC,2L,13831482,13833105,1623
FBgn0004407,PolG2,2L,13831482,13833105,1623
FBgn0053653,Cadps,4,1230837,1271759,40922
FBgn0032364,CG4970,2L,11517391,11519783,2392
FBgn0053654,CG33654,3R,9582515,9583222,707
FBgn0034618,CG9485,2R,21312399,21319569,7170
FBgn0037555,Ada2b,3R,8236632,8240515,3883
FBgn0000153,b,2L,13821248,13823979,2731
FBgn0015609,CadN,2L,17647053,17778340,131287
FBgn0065101,sncRNA:204,X,13128596,13128630,34
FBgn0001223,Hsp22,3L,9372931,9374964,2033
FBgn0001228,CG4456,3L,9372722,9374964,2242
FBgn0065097,sncRNA:357,3L,5567885,5567961,76
FBgn0065092,sncRNA:438,3L,434855,434918,63
FBgn0065071,snoRNA:Or-CD10,X,6531635,6531701,66
FBgn0033380,Phax,2R,9114274,9116030,1756
FBgn0061359,Mvk,2R,12634166,12636141,1975
FBgn0061360,CG33672,2R,12634166,12636141,1975
FBgn0065053,snoRNA:Me18S-C1831,2L,4457603,4457674,71
FBgn0040608,CG14246,3R,26727314,26730117,2803
FBgn0039452,CG14245,3R,26728727,26729341,614
FBgn0067622,LSm-4,2L,10403197,10405203,2006
FBgn0032240,CG17768,2L,10403197,10405203,2006
FBgn0029859,CG15892,X,6293106,6294343,1237
FBgn0029860,CG15891,X,6294517,6295345,828
FBgn0029504,CHES-1-like,X,7682338,7709385,27047
FBgn0041775,tral,3L,12515059,12520954,5895
FBgn0003507,srp,3R,15986152,16004085,17933
FBgn0002524,lace,2L,15499127,15505018,5891
FBgn0037716,Son,3R,9578042,9581225,3183
FBgn0002522,lab,3R,6661427,6678590,17163
FBgn0065098,RNaseMRP:RNA,3R,23730048,23730429,381
FBgn0039157,Myo95E,3R,24154826,24161498,6672
FBgn0011676,Nos,2L,10804274,10837511,33237
FBgn0065088,sncRNA:641,3L,17668588,17668730,142
FBgn0065073,snoRNA:229,2R,23073829,23073968,139
FBgn0037913,fabp,3R,11559896,11567054,7158
FBgn0037912,sea,3R,11559896,11567054,7158
FBgn0032888,CheB38c,2L,20820089,20820867,778
FBgn0051221,CG31221,3R,19412689,19460311,47622
FBgn0031403,CG15387,2L,2225545,2226294,749
FBgn0065087,sncRNA:649,3R,12413388,12413446,58
FBgn0026239,gukh,3R,18984025,19022436,38411
FBgn0052423,shep,3L,5155821,5277944,122123
FBgn0033884,CG13344,2R,13861997,13864156,2159
FBgn0065055,snoRNA:Psi28S-2648,2L,8042189,8042350,161
FBgn0040233,cana,2L,11269780,11277846,8066
FBgn0052831,CG33695,2L,11278021,11279982,1961
FBgn0053696,CNMaR,3L,9644109,9659433,15324
FBgn0052843,Dh31-R,2R,13267798,13295927,28129
FBgn0016919,nompB,2L,21578292,21589423,11131
FBgn0065095,sncRNA:400,X,1558349,1558400,51
FBgn0036783,CheA75a,3L,18252088,18252846,758
FBgn0001624,dlg1,X,11369665,11409776,40111
FBgn0053700,CG33700,3L,9514119,9525544,11425
FBgn0053704,CG33704,2R,20950102,20951094,992
FBgn0065100,sncRNA:254,2L,21680670,21680700,30
FBgn0260455,CG10332,2R,23600914,23601773,859
FBgn0067903,IM18,2R,23600914,23601773,859
FBgn0065105,sncRNA:157,3R,27560928,27560970,42
FBgn0065084,sncRNA:763,X,19301703,19301873,170
FBgn0065096,sncRNA:359,2L,19403535,19403568,33
FBgn0064116,anox,X,21317936,21319296,1360
FBgn0064117,SLIRP1,X,21317936,21319296,1360
FBgn0260458,PGRP-LD,3L,5780051,5784685,4634
FBgn0044419,Pmi,3L,5780051,5784685,4634
FBgn0046874,Pif1B,3R,8774286,8801176,26890
FBgn0042182,CG18749,3R,8244055,8248054,3999
FBgn0064126,CG33722,3R,8244055,8248054,3999
FBgn0260439,Pp2A-29B,2L,8366038,8370090,4052
FBgn0014163,fax,3L,16402796,16411828,9032
FBgn0040076,primo-2,3R,13710017,13711835,1818
FBgn0051469,Argp,3R,13709159,13709939,780
FBgn0040077,primo-1,3R,13710017,13711835,1818
FBgn0037550,CG9667,3R,8125290,8126357,1067
FBgn0065104,sncRNA:158,2L,5206205,5206361,156
FBgn0036713,Mip,3L,17344947,17349666,4719
FBgn0014857,His3.3A,2L,5055058,5056149,1091
FBgn0034518,CG13430,2R,20550334,20552090,1756
FBgn0034519,BORCS7,2R,20550334,20552090,1756
FBgn0053137,CG33137,2R,13175395,13176075,680
FBgn0003742,tra2,2R,14602004,14604337,2333
FBgn0036789,AstC-R2,3L,18485137,18502557,17420
FBgn0035486,Gr64d,3L,4032062,4035703,3641
FBgn0045476,Gr64e,3L,4032141,4035703,3562
FBgn0038880,SIFaR,3R,21276664,21293998,17334
FBgn0065064,snoRNA:Psi28S-291,3R,11223571,11223790,219
FBgn0029890,Fum2,X,6681767,6683696,1929
FBgn0029891,Pink1,X,6683798,6687302,3504
FBgn0029888,ND-ASHI,X,6677262,6679118,1856
FBgn0005672,spi,2L,19567900,19577315,9415
FBgn0028377,gdl-ORF39,3L,15509445,15510837,1392
FBgn0001099,gdl,3L,15509445,15511047,1602
FBgn0051324,Cipc,3R,26106868,26130674,23806
FBgn0053774,CG33774,2R,9399753,9400329,576
FBgn0035497,CG14995,3L,4094343,4103256,8913
FBgn0050056,CG30056,2R,12562060,12562655,595
FBgn0053777,CG33777,3L,4554537,4555236,699
FBgn0065066,snoRNA:Me28S-A2564,3R,29863299,29863344,45
FBgn0065059,snoRNA:660,2R,20945970,20946065,95
FBgn0053784,CG33784,3R,10067905,10068572,667
FBgn0061362,Polr3K,2R,20642466,20643785,1319
FBgn0061361,Tcs1,2R,20642466,20643785,1319
FBgn0050462,ste24c,2R,16995991,16998594,2603
FBgn0050461,CG30461,2R,16995991,16998594,2603
FBgn0035197,CG9130,3L,1252012,1255986,3974
FBgn0035198,CG9133,3L,1252012,1255986,3974
FBgn0041720,snRNA:U2:34ABc,2L,13244370,13244561,191
FBgn0025643,CG3588,X,2919770,2924426,4656
FBgn0020912,Ptx1,3R,30912754,30930682,17928
FBgn0065083,sncRNA:765,2L,5193471,5193516,45
FBgn0063923,Kaz1-ORFB,3L,216625,218058,1433
FBgn0063924,Kaz1-ORFA,3L,216625,216931,306
FBgn0035239,CG18170,3L,1602954,1617355,14401
FBgn0035240,CG33791,3L,1602954,1617355,14401
FBgn0053792,CG33792,2R,12632674,12633454,780
FBgn0065081,sncRNA:838,3L,9716803,9716875,72
FBgn0065058,snoRNA:684,3L,5763345,5763422,77
FBgn0033693,CG13175,2R,12182639,12185506,2867
FBgn0039621,CG14518,3R,29024971,29026159,1188
FBgn0051072,Lerp,3R,26842462,26863130,20668
FBgn0032077,CG9515,2L,8941945,8943257,1312
FBgn0032076,Argl,2L,8939725,8942105,2380
FBgn0033652,ths,2R,11756817,11814424,57607
FBgn0001235,hth,3R,10507561,10639568,132007
FBgn0000056,Adhr,2L,14615552,14618902,3350
FBgn0053096,CG33096,3R,25097672,25102146,4474
FBgn0053867,His-Psi:CR33867,2L,21539129,21541127,1998
FBgn0053868,His2B:CG33868,2L,21537505,21538099,594
FBgn0028991,seq,2R,13176553,13190086,13533
FBgn0053914,CG33914,2R,7036768,7039050,2282
FBgn0065107,sncRNA:128,2L,5196035,5196097,62
FBgn0025455,CycT,3L,17551004,17557788,6784
FBgn0065102,sncRNA:184,2R,21335510,21335544,34
FBgn0065094,sncRNA:419,3R,12362916,12362989,73
FBgn0038683,CG11779,3R,19154097,19159878,5781
FBgn0038682,CG5835,3R,19148632,19153686,5054
FBgn0033628,CG13203,2R,11373607,11377109,3502
FBgn0033739,Dyb,2R,12437345,12452916,15571
FBgn0034081,CG10731,2R,16148812,16149795,983
FBgn0029175,sotv,2R,16145904,16148719,2815
FBgn0027358,Tim9b,X,19616663,19618537,1874
FBgn0031041,Pstk,X,19616663,19618537,1874
FBgn0003435,sm,2R,19517864,19631508,113644
FBgn0024251,bbx,X,21363028,21373145,10117
FBgn0024182,waw,X,21363028,21373145,10117
FBgn0031455,Snapin,2L,2758427,2759677,1250
FBgn0031454,HemK2,2L,2758427,2759677,1250
FBgn0053476,CG33476,2R,10409985,10410570,585
FBgn0038032,CG10096,3R,12390166,12395980,5814
FBgn0038033,CG10097,3R,12390166,12395980,5814
FBgn0052652,lncRNA:CR32652,X,12411018,12412181,1163
FBgn0051224,CG31224,3R,18650121,18659309,9188
FBgn0065048,snoRNA:U3:54Aa,2R,17143521,17143730,209
FBgn0011640,lark,3L,7339266,7341893,2627
FBgn0065099,snRNA:7SKa,3R,7474553,7474996,443
FBgn0053926,Srg3,3L,9443232,9446388,3156
FBgn0053927,CG33927,3R,4689951,4690608,657
FBgn0053928,CG33928,2L,17435891,17436600,709
FBgn0067311,CheB38b,2L,20816456,20817270,814
FBgn0024293,Spn43Ab,2R,7151662,7153642,1980
FBgn0033564,Pex6,2R,10879974,10883202,3228
FBgn0061356,Hao,2R,10883547,10884936,1389
FBgn0066304,Rpp20,X,19744431,19745898,1467
FBgn0066303,CG33932,X,19744431,19745898,1467
FBgn0260466,Indy-2,3R,20042757,20048716,5959
FBgn0064119,CG33934,3R,20042757,20048716,5959
FBgn0002709,mei-218,X,17135985,17142990,7005
FBgn0028581,mei-217,X,17136578,17142990,6412
FBgn0063127,lncRNA:CR33938,3R,6699560,6700164,604
FBgn0047095,CG33939,X,19171077,19174900,3823
FBgn0062928,hpRNA:CR33940,3L,19486745,19488439,1694
FBgn0062961,lncRNA:CR33942,2R,18711391,18711951,560
FBgn0047334,BG642312,3L,6232469,6233381,912
FBgn0046756,asRNA:CR33945,3R,31767973,31769423,1450
FBgn0047000,CG33946,3L,6220578,6220949,371
FBgn0083068,CG33947,3L,11096496,11098556,2060
FBgn0029153,Menl-2,2R,16414815,16419398,4583
FBgn0029154,Menl-1,2R,16414815,16419398,4583
FBgn0004507,Glyp,2L,2130813,2137296,6483
FBgn0053632,CG33632,2R,12522023,12522731,708
FBgn0040606,CG6503,3R,26424698,26425105,407
FBgn0066084,RpL41,2R,24903416,24903935,519
FBgn0083167,Neb-cGP,X,10460736,10461878,1142
FBgn0031414,eys,2L,2311680,2358944,47264
FBgn0034903,sona,2R,23753477,23798395,44918
FBgn0001297,kay,3R,29765995,29794113,28118
FBgn0030117,ric8b,X,9260697,9261332,635
FBgn0032763,CG17568,2L,19179749,19181702,1953
FBgn0024963,GluClalpha,3R,19730715,19775231,44516
FBgn0036210,CG14130,3L,11815444,11816710,1266
FBgn0032536,Ance-3,2L,13914725,13956188,41463
FBgn0032812,Hakai,2L,19580612,19582474,1862
FBgn0001149,GstD1,3R,12367817,12369268,1451
FBgn0035766,eco,3L,7335442,7339340,3898
FBgn0034314,nopo,2R,18180496,18182519,2023
FBgn0053958,CG33958,2R,18184382,18192851,8469
FBgn0034315,CG5721,2R,18182435,18184090,1655
FBgn0052803,Ldaf1,X,1900699,1901911,1212
FBgn0031191,Cp110,X,22482082,22487458,5376
FBgn0017579,RpL14,3L,8601006,8602392,1386
FBgn0031220,CG4822,2L,116970,121754,4784
FBgn0025388,Alms1a,X,4631052,4636004,4952
FBgn0025387,Alms1b,X,4627380,4630936,3556
FBgn0000152,Axs,X,16680089,16683895,3806
FBgn0003900,twi,2R,22985374,23048325,62951
FBgn0036685,CG6664,3L,17012886,17016180,3294
FBgn0030778,CG4678,X,16696131,16711145,15014
FBgn0013799,Deaf1,3L,19818174,19830686,12512
FBgn0032515,loqs,2L,13382652,13385671,3019
FBgn0052202,CG32202,3L,18682184,18682860,676
FBgn0050280,CG30280,2R,22113589,22114841,1252
FBgn0033712,mIF3,2R,12321238,12322797,1559
FBgn0027094,AlaRS,2L,8378262,8381764,3502
FBgn0039648,CG14515,3R,29197556,29199211,1655
FBgn0032551,CG18636,2L,14783301,14784598,1297
FBgn0031322,CG5001,2L,1185757,1196807,11050
FBgn0000277,CecA2,3R,30212156,30212568,412
FBgn0035945,CG5026,3L,8968528,8971752,3224
FBgn0031575,Cep97,2L,3867697,3871425,3728
FBgn0034165,CG6435,2R,16873772,16874977,1205
FBgn0034009,CG8155,2R,15317817,15322171,4354
FBgn0031995,CG8475,2L,8190808,8196918,6110
FBgn0036603,CG13062,3L,16314285,16315149,864
FBgn0036607,CG13059,3L,16323672,16324308,636
FBgn0004047,Yp3,X,13759546,13761547,2001
FBgn0067317,Cby,3R,21868003,21868770,767
FBgn0014464,Cp7Fa,X,8470888,8473087,2199
FBgn0025632,CG4313,X,2041868,2055414,13546
FBgn0011837,Tis11,X,12659415,12682560,23145
FBgn0053963,lncRNA:CR33963,X,12659462,12660632,1170
FBgn0036916,Mtr3,3L,19912405,19913715,1310
FBgn0011272,RpL13,2L,9967313,9968645,1332
FBgn0053964,CG33964,2R,12182639,12185506,2867
FBgn0033453,Sting,2R,9842686,9845512,2826
FBgn0010406,RNaseX25,3L,7970588,7972449,1861
FBgn0036493,CG7255,3L,15304255,15311195,6940
FBgn0003028,ovo,X,5048273,5070929,22656
FBgn0020372,TM4SF,2R,23878197,23880860,2663
FBgn0032896,CG14400,2L,20856987,20857891,904
FBgn0053965,CG33965,3L,1232882,1234015,1133
FBgn0053966,CG33966,3L,1234130,1235420,1290
FBgn0031726,Cyp6a16,2L,5620615,5623762,3147
FBgn0004828,His3.3B,X,9152523,9156669,4146
FBgn0053517,Dop2R,X,20004680,20062706,58026
FBgn0035021,CG4622,2R,24533374,24556300,22926
FBgn0035083,Tina-1,2R,24940625,24942413,1788
FBgn0037137,Nopp140,3L,21832774,21836685,3911
FBgn0010241,Mdr50,2R,14246966,14252597,5631
FBgn0002283,l(3)73Ah,3L,16588475,16590132,1657
FBgn0039020,CG17141,3R,22746446,22747599,1153
FBgn0038405,CG8927,3R,16181020,16186235,5215
FBgn0030863,CG8188,X,17698917,17703024,4107
FBgn0003687,Tbp,2R,21686192,21687642,1450
FBgn0051007,CG31007,3R,30991700,30992457,757
FBgn0032157,Etl1,2L,9908830,9912608,3778
FBgn0043841,vir-1,2L,12403270,12423439,20169
FBgn0010265,RpS13,2L,8363477,8364662,1185
FBgn0022893,Df31,2L,21626309,21629932,3623
FBgn0037385,glob3,3R,5830062,5831785,1723
FBgn0052857,CG32857,X,21615449,21617617,2168
FBgn0032391,escl,2L,11990927,11992848,1921
FBgn0036374,Spt20,3L,13502707,13511541,8834
FBgn0034566,CG9313,2R,20978901,20984043,5142
FBgn0031285,CG3662,2L,821289,824337,3048
FBgn0004050,z,X,2447769,2450550,2781
FBgn0004644,hh,3R,23128169,23141906,13737
FBgn0031765,CG9109,2L,6025870,6034423,8553
FBgn0030522,amrt,X,13782459,13783381,922
FBgn0028540,CG9008,2L,13774340,13780165,5825
FBgn0000459,disco,X,16210598,16216750,6152
FBgn0038980,Octbeta1R,3R,22497215,22520078,22863
FBgn0000529,bsh,2L,19765776,19769067,3291
FBgn0010607,l(2)05714,2L,4970135,4973921,3786
FBgn0003943,Ubi-p63E,3L,3899259,3903184,3925
FBgn0052072,Elo68alpha,3L,11101875,11103030,1155
FBgn0052056,scramb1,3L,10220483,10225240,4757
FBgn0035258,CG13931,3L,1700956,1702407,1451
FBgn0015773,NetA,X,14604012,14653928,49916
FBgn0003002,opa,3R,4852813,4869979,17166
FBgn0037326,CG14669,3R,5414527,5458394,43867
FBgn0004087,Dhfr,3R,16481167,16481878,711
FBgn0033631,Sod3,2R,11380347,11384114,3767
FBgn0000370,crc,2L,21310866,21319527,8661
FBgn0026433,Grip128,X,15468281,15472119,3838
FBgn0053969,CG33969,3L,20391685,20393553,1868
FBgn0004363,porin,2L,10847227,10850848,3621
FBgn0036680,Cpr73D,3L,16939100,16957689,18589
FBgn0013263,Trl,3L,14747929,14761049,13120
FBgn0036306,CG10973,3L,12753239,12754774,1535
FBgn0260479,CG31904,2L,7734415,7738809,4394
FBgn0038547,CG17803,3R,17798877,17801512,2635
FBgn0024941,RSG7,X,16838173,16844433,6260
FBgn0053970,osy,3R,26318355,26362588,44233
FBgn0014396,tim,2L,3493986,3508119,14133
FBgn0013765,cnn,2R,13439314,13450475,11161
FBgn0031270,CG13689,2L,602813,604430,1617
FBgn0016977,spen,2L,159032,203397,44365
FBgn0016930,Dyrk2,2L,14184478,14234126,49648
FBgn0031971,Sirup,2L,7998869,7999676,807
FBgn0010488,NAT1,2R,12915994,12923734,7740
FBgn0033781,CG13319,2R,12923904,12924664,760
FBgn0011205,fbl,3L,20384429,20391913,7484
FBgn0053971,Ir62a,3L,1529439,1531259,1820
FBgn0020381,Dredd,X,633622,635545,1923
FBgn0035209,msd1,3L,1331744,1332326,582
FBgn0037525,CG17816,3R,7855582,7886733,31151
FBgn0031623,Taf12L,2L,4700835,4701485,650
FBgn0004911,asRNA:Eig63F-2,3L,3934718,3935992,1274
FBgn0000406,Cyt-b5-r,2L,16788774,16790721,1947
FBgn0039544,CG12877,3R,27707100,27710857,3757
FBgn0014869,Pglym78,3R,29148248,29149901,1653
FBgn0013720,pck,X,1470666,1472325,1659
FBgn0003638,su(w[a]),X,1012779,1046040,33261
FBgn0000276,CecA1,3R,30210874,30211273,399
FBgn0010438,mtSSB,3R,16204194,16205250,1056
FBgn0021764,sdk,X,686834,749496,62662
FBgn0040099,lectin-28C,2L,7857077,7860120,3043
FBgn0004618,gl,3R,18367927,18372738,4811
FBgn0029854,CG3566,X,6274972,6276724,1752
FBgn0000278,CecB,3R,30213315,30213797,482
FBgn0038002,CG12256,3R,12225282,12226339,1057
FBgn0051274,CG31274,3R,16993016,16994532,1516
FBgn0038427,ema,3R,16436880,16441661,4781
FBgn0035976,PGRP-LC,3L,9338810,9348336,9526
FBgn0039454,CG14247,3R,26737610,26738593,983
FBgn0027514,CG1024,3R,6377349,6380328,2979
FBgn0038063,Octbeta2R,3R,12550625,12595725,45100
FBgn0053977,Dpm3,3R,13402559,13403051,492
FBgn0053978,CG33978,4,157575,175639,18064
FBgn0000551,Edg78E,3L,21296763,21297803,1040
FBgn0032130,brwl,2L,9568890,9573572,4682
FBgn0035879,GAPcenA,3L,8346561,8352279,5718
FBgn0035880,Culd,3L,8352355,8356296,3941
FBgn0001091,Gapdh1,2R,7791901,7793380,1479
FBgn0031261,nAChRbeta3,2L,545129,547096,1967
FBgn0031859,CG17377,2L,6801358,6802840,1482
FBgn0001125,Got2,2L,1984512,1987758,3246
FBgn0024983,CG4293,X,527941,530291,2350
FBgn0000640,Fbp2,2L,9426784,9427917,1133
FBgn0050087,CG30087,2R,15692448,15693751,1303
FBgn0053460,CG33460,2R,15694092,15695232,1140
FBgn0025741,PlexA,4,1009895,1027101,17206
FBgn0000044,Act57B,2R,20944021,20946431,2410
FBgn0034495,CG11788,2R,20274597,20276142,1545
FBgn0039925,Kif3C,4,1147466,1169239,21773
FBgn0033104,CG15237,2R,6809044,6809766,722
FBgn0026086,Adar,X,1773725,1788065,14340
FBgn0036203,Muc68D,3L,11767299,11772157,4858
FBgn0028741,fab1,2R,17773964,17781930,7966
FBgn0010339,128up,2R,12037298,12038851,1553
FBgn0053983,obst-H,3L,15528265,15529243,978
FBgn0003300,run,X,20690670,20697321,6651
FBgn0037635,CG9837,3R,8807679,8813579,5900
FBgn0040508,ACXC,2L,12912530,12916774,4244
FBgn0053987,lncRNA:CR33987,2L,22019208,22020254,1046
FBgn0028979,tio,2L,22019208,22025734,6526
FBgn0053988,Mid1,2R,24695378,24736657,41279
FBgn0052176,CG32176,3L,17433868,17437971,4103
FBgn0053082,Rpp21,X,1030758,1033119,2361
FBgn0032023,witty,2L,8338287,8342056,3769
FBgn0026575,hang,X,16422831,16438454,15623
FBgn0067905,Dso2,2R,20870392,20870678,286
FBgn0037812,CG18545,3R,10340949,10341668,719
FBgn0036793,CG4174,3L,18600150,18617943,17793
FBgn0036799,CG13380,3L,18600150,18617943,17793
FBgn0025637,SkpA,X,656114,657899,1785
FBgn0000552,Edg84A,3R,6684445,6685157,712
FBgn0032151,nAChRalpha6,2L,9793317,9886250,92933
FBgn0038575,CG7208,3R,18183656,18185715,2059
FBgn0043791,phu,3R,9494801,9496723,1922
FBgn0000055,Adh,2L,14615552,14618902,3350
FBgn0034978,CG3257,2R,24116792,24123263,6471
FBgn0039229,Saf-B,3R,24817464,24822350,4886
FBgn0032259,CG6144,2L,10488694,10490461,1767
FBgn0032815,CG10462,2L,19732080,19735980,3900
FBgn0052625,CG32625,X,13756164,13756826,662
FBgn0010240,Lcch3,X,15925105,15928529,3424
FBgn0029526,CR18166,X,479864,481826,1962
FBgn0003366,sev,X,11071441,11086299,14858
FBgn0041789,Pax,2L,19400753,19426596,25843
FBgn0035000,CG13578,2R,24377831,24378740,909
FBgn0013718,nuf,3L,14190870,14233250,42380
FBgn0030984,tgy,X,19125003,19127316,2313
FBgn0039736,CG7912,3R,30006034,30009189,3155
FBgn0022359,Sodh2,3R,10876384,10878257,1873
FBgn0024250,brk,X,7307939,7311132,3193
FBgn0020906,Jon25Bi,2L,4954279,4955144,865
FBgn0030336,CG1578,X,11808506,11816551,8045
FBgn0031762,CG9098,2L,6007364,6012338,4974
FBgn0000719,fog,X,22824317,22855194,30877
FBgn0030581,CG14408,X,14826867,14832033,5166
FBgn0050383,CG30383,2R,7823943,7825141,1198
FBgn0030874,Spt7,X,17850460,17851889,1429
FBgn0030262,Vago,X,11089290,11090219,929
FBgn0004643,Zw10,X,2604197,2606824,2627
FBgn0034997,CG3376,2R,24258013,24265213,7200
FBgn0000320,eya,2L,6527447,6546976,19529
FBgn0029836,CG5928,X,6067958,6069264,1306
FBgn0036599,CG13044,3L,16302490,16303178,688
FBgn0045842,yuri,2L,15257267,15264692,7425
FBgn0053093,CG33093,3R,22530694,22531922,1228
FBgn0027101,Dyrk3,4,1225089,1230713,5624
FBgn0039924,PIP4K,4,1192419,1196848,4429
FBgn0053993,Egfrap,3L,5933036,5950658,17622
FBgn0040344,Lztr1,X,922889,927582,4693
FBgn0034121,CG6262,2R,16359730,16363524,3794
FBgn0004463,Polr3B,2R,12039041,12042623,3582
FBgn0031515,CG9664,2L,3291245,3294706,3461
FBgn0053301,CG33301,2L,10049580,10051201,1621
FBgn0014903,CG14630,X,1031496,1033165,1669
FBgn0037046,CG10581,3L,21033554,21034203,649
FBgn0053995,CG33995,2L,5043270,5048365,5095
FBgn0034286,dpr13,2R,17975122,18007902,32780
FBgn0032955,CG2201,2L,21614232,21624080,9848
FBgn0050098,CG30098,2R,16354224,16355215,991
FBgn0032405,firl,2L,12063457,12066775,3318
FBgn0029608,CG3091,X,2252332,2254197,1865
FBgn0031637,mxt,2L,4841482,4847295,5813
FBgn0034139,CG4927,2R,16572082,16574154,2072
FBgn0030897,Frq1,X,18155369,18174744,19375
FBgn0031945,CG7191,2L,7767628,7775033,7405
FBgn0015664,Dref,2L,9964147,9967229,3082
FBgn0039592,CG14062,3R,28641585,28642891,1306
FBgn0053679,CG33679,2L,15058303,15059120,817
FBgn0053258,CG33258,3L,16082551,16083638,1087
FBgn0053544,Vkor,2R,16778365,16778994,629
FBgn0053998,CG33998,2R,18738492,18739143,651
FBgn0054001,CG34001,3L,10631079,10634612,3533
FBgn0054002,CG34002,3L,17858474,17860482,2008
FBgn0054003,NimB3,2L,13967464,13967985,521
FBgn0040658,CG13516,2R,22669145,22670622,1477
FBgn0053772,CG33772,3L,22651855,22652525,670
FBgn0053294,CR33294,3R,4186963,4196210,9247
FBgn0054007,CG34007,2L,20495030,20495758,728
FBgn0054008,CG34008,3R,20580683,20581522,839
FBgn0054010,Glyat,2L,8009603,8010652,1049
FBgn0054015,CG34015,X,16447568,16448302,734
FBgn0054027,CG34027,3R,25103670,25109032,5362
FBgn0054030,CG34030,3L,7073476,7075247,1771
FBgn0054034,CG34034,3R,21738345,21739110,765
FBgn0038156,side-IV,3R,13450590,13464184,13594
FBgn0053635,CG33635,2L,157836,158664,828
FBgn0053465,CG33465,2R,15819114,15821114,2000
FBgn0054039,CG34039,3L,14560000,14562613,2613
FBgn0065110,ppk10,2L,10450134,10452396,2262
FBgn0054044,lncRNA:CR34044,3R,13712469,13714204,1735
FBgn0054045,CG34045,2R,19330889,19335188,4299
FBgn0054054,CG34054,2R,11409810,11410438,628
FBgn0065108,ppk16,2L,9771155,9775030,3875
FBgn0065109,ppk11,2L,9771155,9775030,3875
FBgn0054056,CG34056,3L,895951,897364,1413
FBgn0054057,CG34057,3L,897380,898772,1392
FBgn0260453,CG17140,2L,10843014,10845664,2650
FBgn0260454,CG17139,2L,10843014,10845664,2650
FBgn0052529,Hers,X,19866146,19908108,41962
FBgn0013696,mt:tRNA:Ile-GAT,mitochondrion_genome,1,65,64
FBgn0013703,mt:tRNA:Gln-TTG,mitochondrion_genome,97,165,68
FBgn0013700,mt:tRNA:Met-CAT,mitochondrion_genome,171,239,68
FBgn0013680,mt:ND2,mitochondrion_genome,240,1263,1023
FBgn0013709,mt:tRNA:Trp-TCA,mitochondrion_genome,1264,1329,65
FBgn0013690,mt:tRNA:Cys-GCA,mitochondrion_genome,1322,1383,61
FBgn0013710,mt:tRNA:Tyr-GTA,mitochondrion_genome,1403,1468,65
FBgn0013674,mt:CoI,mitochondrion_genome,1474,3009,1535
FBgn0013699,mt:tRNA:Leu-TAA,mitochondrion_genome,3012,3077,65
FBgn0013675,mt:CoII,mitochondrion_genome,3083,3767,684
FBgn0013697,mt:tRNA:Lys-CTT,mitochondrion_genome,3768,3838,70
FBgn0013691,mt:tRNA:Asp-GTC,mitochondrion_genome,3840,3906,66
FBgn0013673,mt:ATPase8,mitochondrion_genome,3907,4068,161
FBgn0013672,mt:ATPase6,mitochondrion_genome,4062,4736,674
FBgn0013676,mt:CoIII,mitochondrion_genome,4736,5524,788
FBgn0013694,mt:tRNA:Gly-TCC,mitochondrion_genome,5543,5607,64
FBgn0013681,mt:ND3,mitochondrion_genome,5608,5961,353
FBgn0013689,mt:tRNA:Ala-TGC,mitochondrion_genome,5983,6047,64
FBgn0013704,mt:tRNA:Arg-TCG,mitochondrion_genome,6062,6124,62
FBgn0013701,mt:tRNA:Asn-GTT,mitochondrion_genome,6125,6190,65
FBgn0013705,mt:tRNA:Ser-GCT,mitochondrion_genome,6191,6258,67
FBgn0013684,mt:ND5,mitochondrion_genome,6409,8125,1716
FBgn0013695,mt:tRNA:His-GTG,mitochondrion_genome,8141,8206,65
FBgn0013683,mt:ND4L,mitochondrion_genome,9545,9835,290
FBgn0013707,mt:tRNA:Thr-TGT,mitochondrion_genome,9838,9902,64
FBgn0013685,mt:ND6,mitochondrion_genome,9971,10495,524
FBgn0013678,mt:Cyt-b,mitochondrion_genome,10499,11635,1136
FBgn0013706,mt:tRNA:Ser-TGA,mitochondrion_genome,11638,11703,65
FBgn0013679,mt:ND1,mitochondrion_genome,11721,12659,938
FBgn0013698,mt:tRNA:Leu-TAG,mitochondrion_genome,12670,12734,64
FBgn0013686,mt:lrRNA,mitochondrion_genome,12735,14058,1323
FBgn0013708,mt:tRNA:Val-TAC,mitochondrion_genome,14059,14130,71
FBgn0013688,mt:srRNA,mitochondrion_genome,14131,14916,785
FBgn0041004,CG17715,2L,22844220,22854541,10321
FBgn0058191,CG40191,2R,1264140,1267747,3607
FBgn0040011,Slmap,2L,22579072,22585843,6771
FBgn0040009,CG17490,2L,22537668,22540597,2929
FBgn0039958,CG12567,2L,23161122,23174484,13362
FBgn0040038,klhl10,Unmapped_Scaffold_8_D1580_D1567,53442,85529,32087
FBgn0058006,CG40006,2L,22622417,22756349,133932
FBgn0000384,cta,2L,22981816,22992951,11135
FBgn0058005,CR40005,2L,22949038,22950476,1438
FBgn0039966,Rab21,X,23012140,23013409,1269
FBgn0025837,CG17636,X,124370,126714,2344
FBgn0025836,RhoGAP1A,X,127449,140340,12891
FBgn0025835,CG17707,X,142731,148426,5695
FBgn0003559,su(f),X,23096771,23101431,4660
FBgn0040514,CG17169,X,23084672,23085536,864
FBgn0039943,CG17168,X,23082738,23084576,1838
FBgn0039942,CG17163,X,23080759,23082709,1950
FBgn0039941,CG17167,X,23068301,23081144,12843
FBgn0039965,Coa7,X,23013495,23016586,3091
FBgn0063670,CG40228,3L,27082091,27083906,1815
FBgn0028697,RpL15,3L,27267255,27268445,1190
FBgn0058002,ND-AGGG,3L,24976254,24977118,864
FBgn0037549,CG7878,3R,8122725,8125273,2548
FBgn0040022,Set1,3L,25107594,25115180,7586
FBgn0058160,Sph242,3L,26215815,26229433,13618
FBgn0040056,CG17698,3L,23737960,23749058,11098
FBgn0039955,CG41099,3R,3846729,3868401,21672
FBgn0058198,CG40198,3R,4160610,4162235,1625
FBgn0058298,CG40298,3L,23726829,23727989,1160
FBgn0083992,Mkp,3L,182522,184540,2018
FBgn0260451,CG14042,2L,5037709,5040818,3109
FBgn0034389,Mctp,2R,18761758,18774824,13066
FBgn0083940,RhoU,X,10086527,10148876,62349
FBgn0083942,CG34106,2L,17131024,17173118,42094
FBgn0083943,CG34107,3R,10224909,10225587,678
FBgn0083946,lobo,3R,25169565,25193776,24211
FBgn0083949,side-III,3R,5862865,5959555,96690
FBgn0083950,side-VI,3R,10972381,11050175,77794
FBgn0083951,CG34115,2R,20975488,20976934,1446
FBgn0083952,CG34116,3L,19805241,19806036,795
FBgn0083953,CG34117,3R,9399570,9400053,483
FBgn0083956,ldd,X,21123634,21140951,17317
FBgn0083960,CG34124,2L,4958411,4965430,7019
FBgn0083961,CG34125,2L,4965673,4966399,726
FBgn0083962,CG34126,2L,4981614,4992702,11088
FBgn0083963,Nlg3,3R,7570281,7639434,69153
FBgn0083967,Muted,3R,22362620,22364580,1960
FBgn0083968,CG34132,2L,7885503,7886109,606
FBgn0083969,CG34133,3R,29869365,29875159,5794
FBgn0083970,CG34134,2L,8190297,8190781,484
FBgn0083971,CG34135,3R,8749206,8768191,18985
FBgn0083972,CG34136,2L,21096922,21098932,2010
FBgn0083973,dunk,2L,22151623,22152640,1017
FBgn0083974,CG34138,3R,19634949,19635879,930
FBgn0083975,Nlg4,3R,20204809,20245473,40664
FBgn0083976,CG34140,3L,182522,184424,1902
FBgn0083977,CG34141,2R,9260278,9263971,3693
FBgn0083978,CG17672,3L,13028962,13036504,7542
FBgn0083981,RunxA,X,20590252,20623773,33521
FBgn0083983,mRpL34,2R,16098948,16099337,389
FBgn0083984,CG34148,3R,21877870,21878686,816
FBgn0083985,CG34149,3R,22380128,22381253,1125
FBgn0083986,CG34150,3R,24814262,24814930,668
FBgn0083987,snRNA:U11,3L,3893056,3893330,274
FBgn0083988,snoRNA:Me28S-C3420a,2R,12199662,12199752,90
FBgn0083990,lncRNA:sphinx,4,975168,977261,2093
FBgn0083991,CG34155,3R,30554554,30560199,5645
FBgn0026401,Nipped-B,2R,4691672,4729017,37345
FBgn0002566,lt,2L,22924795,22943135,18340
FBgn0016976,stnA,X,22980722,23004648,23926
FBgn0016975,stnB,X,22980722,23004648,23926
FBgn0003256,rl,2R,1071462,1125927,54465
FBgn0032997,CG17486,2R,4619030,4620833,1803
FBgn0039979,CR40282,2R,4730439,4731241,802
FBgn0040759,CG13177,2R,12163675,12164896,1221
FBgn0052218,lncRNA:CR32218,3L,19895216,19896391,1175
FBgn0033000,CG14464,2R,4829246,4830587,1341
FBgn0064225,RpL5,2L,22532279,22536884,4605
FBgn0051144,asRNA:CR31144,3R,11222414,11223029,615
FBgn0040007,RpL38,2R,4515388,4516458,1070
FBgn0010247,Parp1,3R,3461351,3587054,125703
FBgn0020908,Scp1,2R,2932595,2968052,35457
FBgn0011288,Snap25,3L,24074180,24299205,225025
FBgn0046692,Stlk,2R,4546691,4565281,18590
FBgn0084017,CR41454,3L,23136623,23138271,1648
FBgn0039994,conu,2R,4744348,4758048,13700
FBgn0058439,CG40439,2L,22797519,22798276,757
FBgn0044872,FucTC,X,23008766,23011303,2537
FBgn0040005,CG17883,2R,4671853,4673639,1786
FBgn0069973,CG40485,X,22960609,22962360,1751
FBgn0084049,CR41440,2R,4731514,4732343,829
FBgn0058470,CG40470,3L,23839860,23986410,146550
FBgn0040010,CG17493,2L,22550064,22556295,6231
FBgn0058045,CG40045,3L,24028515,24035859,7344
FBgn0083048,snoRNA:Psi18S-1377d,3R,30207156,30207291,135
FBgn0082999,snoRNA:Psi28S-1192c,X,17144107,17144240,133
FBgn0083121,Uhg7,3L,1666288,1667307,1019
FBgn0082924,snoRNA:Or-aca2,X,7901062,7901203,141
FBgn0082966,snoRNA:Psi28S-3327b,3L,13042944,13043083,139
FBgn0039946,ATbp,X,23106003,23108331,2328
FBgn0083010,snoRNA:Psi28S-1135c,X,17146248,17146390,142
FBgn0082927,snoRNA:Me28S-G3255b,2R,9096763,9096844,81
FBgn0040799,CG13051,3L,16264713,16265100,387
FBgn0082944,snoRNA:Me28S-A2634c,3L,1666437,1666522,85
FBgn0082997,snoRNA:Psi28S-1232,X,6743675,6743815,140
FBgn0082974,snoRNA:Psi28S-3305c,3R,28603371,28603522,151
FBgn0083015,snoRNA:Psi18S-920,3L,11822984,11823124,140
FBgn0083124,Uhg4,2R,9095273,9097312,2039
FBgn0082960,snoRNA:Psi28S-3405a,3R,28601529,28601668,139
FBgn0082936,snoRNA:Me28S-C2645c,2L,20648282,20648356,74
FBgn0082967,snoRNA:Psi28S-3327a,3L,13042767,13042906,139
FBgn0082961,snoRNA:Psi28S-3385b,3R,5596201,5596340,139
FBgn0082987,snoRNA:Psi28S-2444,2R,19443127,19443256,129
FBgn0046706,Haspin,2R,4014111,4049342,35231
FBgn0039944,CG17162,X,23084960,23096735,11775
FBgn0083123,Uhg5,2R,14621601,14624498,2897
FBgn0037997,CG14742,3R,12214501,12215659,1158
FBgn0083003,snoRNA:Psi28S-1175c,2R,22607385,22607520,135
FBgn0039977,Spf30,3L,23715023,23716689,1666
FBgn0082943,snoRNA:Me28S-A982a,2R,9096237,9096313,76
FBgn0058354,CR40354,3L,25201942,25203341,1399
FBgn0083040,snoRNA:Psi18S-1854c,X,17145210,17145349,139
FBgn0082949,snoRNA:Me18S-U1356a,3L,20454007,20454085,78
FBgn0082928,snoRNA:Me28S-G3255a,2R,9095996,9096080,84
FBgn0051514,asRNA:CR31514,3R,9779519,9782693,3174
FBgn0082923,snoRNA:Or-aca3,3R,27923915,27924061,146
FBgn0058469,lncRNA:CR40469,X,122493,122706,213
FBgn0082994,snoRNA:Psi28S-1837c,3L,5763946,5764084,138
FBgn0082979,snoRNA:Psi28S-3091a,3R,5596697,5596831,134
FBgn0058068,CR40068,2R,1618172,1618585,413
FBgn0039945,CG17159,X,23084960,23092631,7671
FBgn0040682,CG14664,3R,5224139,5225542,1403
FBgn0082976,snoRNA:Psi28S-3305a,3R,28601698,28601847,149
FBgn0082978,snoRNA:Psi28S-3091b,3R,5596526,5596658,132
FBgn0024804,Dbp80,3L,27279316,27422159,142843
FBgn0083001,snoRNA:Psi28S-1192a,X,17144435,17144574,139
FBgn0063368,Gpb5,2L,23311700,23312464,764
FBgn0069923,CG41128,3R,3750363,3752353,1990
FBgn0032914,CG14397,2L,21091227,21094864,3637
FBgn0083044,snoRNA:Psi18S-1397,3L,5762860,5763000,140
FBgn0083039,snoRNA:Psi18S-301,3R,20574906,20575043,137
FBgn0082988,snoRNA:Psi28S-2442b,3R,5598423,5598566,143
FBgn0082975,snoRNA:Psi28S-3305b,3R,28602340,28602489,149
FBgn0082919,snoRNA:Or-CD4,2R,14624253,14624330,77
FBgn0083012,snoRNA:Psi28S-1135a,X,17146612,17146759,147
FBgn0083055,snoRNA:Psi18S-1295,3R,20822610,20822749,139
FBgn0082989,snoRNA:Psi28S-2442a,3R,5598638,5598777,139
FBgn0082972,snoRNA:Psi28S-3316a,2R,21326739,21326870,131
FBgn0082983,snoRNA:Psi28S-2626,3R,30207898,30208039,141
FBgn0083000,snoRNA:Psi28S-1192b,X,17144283,17144420,137
FBgn0040020,MED21,3L,25114924,25115946,1022
FBgn0083013,snoRNA:Psi28S-1060,X,6742852,6743001,149
FBgn0040531,CG11741,3R,8528423,8528877,454
FBgn0083028,snoRNA:Psi18S-525k,2L,5202383,5202522,139
FBgn0082995,snoRNA:Psi28S-1837b,3L,5764113,5764249,136
FBgn0058263,MFS17,2R,2494742,2565385,70643
FBgn0083120,Uhg8,3L,20453293,20454731,1438
FBgn0082981,snoRNA:Psi28S-2949,2R,9095372,9095526,154
FBgn0083004,snoRNA:Psi28S-1175b,2R,22607232,22607372,140
FBgn0063298,asRNA:CR31429,3R,9022057,9024018,1961
FBgn0040973,CG16824,2L,13293009,13293415,406
FBgn0082957,snoRNA:Psi28S-3405d,3R,28602556,28602695,139
FBgn0083011,snoRNA:Psi28S-1135b,X,17146401,17146545,144
FBgn0082958,snoRNA:Psi28S-3405c,3R,28602147,28602286,139
FBgn0082938,snoRNA:Me28S-C2645a,2L,20647817,20647891,74
FBgn0039993,BckdhB,2R,1590484,1596457,5973
FBgn0083049,snoRNA:Psi18S-1377c,3R,30207322,30207458,136
FBgn0082986,snoRNA:Psi28S-2562,3R,20822926,20823060,134
FBgn0082971,snoRNA:Psi28S-3316b,2R,21326882,21327022,140
FBgn0082945,snoRNA:Me28S-A2634b,3L,1666665,1666745,80
FBgn0082925,snoRNA:Or-aca1,2R,22607544,22607678,134
FBgn0083027,snoRNA:Psi18S-531,X,763083,763234,151
FBgn0082942,snoRNA:Me28S-A982b,2R,9096506,9096582,76
FBgn0083005,snoRNA:Psi28S-1175a,2R,22607085,22607220,135
FBgn0082935,snoRNA:Me28S-G1083a,2R,24184840,24184923,83
FBgn0083054,snoRNA:Psi18S-1347a,2R,18142802,18142938,136
FBgn0083006,snoRNA:Psi28S-1153,2R,13557539,13557686,147
FBgn0082998,snoRNA:Psi28S-1192d,X,17143934,17144068,134
FBgn0069969,CG40498,2R,924636,951252,26616
FBgn0083047,snoRNA:Psi18S-1377e,3R,30206976,30207112,136
FBgn0082959,snoRNA:Psi28S-3405b,3R,28601877,28602016,139
FBgn0082954,snoRNA:Psi28S-3571,3R,5597596,5597739,143
FBgn0020660,eIF4B,3L,27842669,27858271,15602
FBgn0082980,snoRNA:Psi28S-2996,2L,22535458,22535593,135
FBgn0082962,snoRNA:Psi28S-3385a,3R,5596360,5596509,149
FBgn0085188,CG34159,2L,10202520,10204317,1797
FBgn0085191,CG34162,2L,11531820,11533756,1936
FBgn0085192,CG34163,2L,11988270,11988801,531
FBgn0085193,CG34164,2L,12056348,12058251,1903
FBgn0085194,CG34165,2L,14713750,14714526,776
FBgn0085195,CG34166,2L,14743193,14743879,686
FBgn0085197,CG34168,2L,16134714,16135272,558
FBgn0085201,COX7AL2,2L,2192525,2197912,5387
FBgn0085203,CG34174,2L,2214266,2215167,901
FBgn0085208,CG34179,2L,6046651,6048706,2055
FBgn0085209,CG34180,2L,6060510,6060938,428
FBgn0085212,CG34183,2L,9890061,9890772,711
FBgn0085217,CG34188,2R,15427091,15428023,932
FBgn0085220,Ufm1,2R,16951837,16952581,744
FBgn0085224,CG34195,2R,17733238,17734483,1245
FBgn0085229,CG34200,2R,5757662,5758067,405
FBgn0085231,CG34202,2R,20752586,20753739,1153
FBgn0085232,CG34203,2R,21281063,21281656,593
FBgn0085234,CG34205,2R,22130112,22131299,1187
FBgn0085236,CG34207,2R,22329195,22329720,525
FBgn0085237,CG34208,2R,22333126,22333505,379
FBgn0085241,CG34212,2R,6049874,6050286,412
FBgn0085242,CG34213,2R,23967124,23967745,621
FBgn0085243,CG34214,2R,24665427,24666022,595
FBgn0085244,CG34215,2R,6831296,6831793,497
FBgn0085246,CG34217,2R,8227990,8228727,737
FBgn0085248,CG34219,2R,8917708,8918877,1169
FBgn0085249,CG34220,2R,10041065,10043507,2442
FBgn0085256,CG34227,2R,11248126,11248610,484
FBgn0085257,CG34228,2R,11651857,11652339,482
FBgn0085260,CG34231,2R,11986008,11987653,1645
FBgn0085261,CG34232,2R,12164909,12165812,903
FBgn0085263,CG34234,2R,12486719,12487391,672
FBgn0085271,CG34242,3L,12533996,12534403,407
FBgn0085273,CG34244,3L,14235053,14235941,888
FBgn0085276,CG34247,3L,16261185,16261605,420
FBgn0085279,CG34250,3L,17476222,17477103,881
FBgn0085280,CG34251,3L,17671622,17683581,11959
FBgn0085282,CG34253,3L,18086674,18087320,646
FBgn0085284,Blos3,3L,18870224,18870897,673
FBgn0085285,CG34256,3L,18988736,18989815,1079
FBgn0085290,Targ3,3L,21196831,21197738,907
FBgn0085291,CR34262,3L,21959254,21960503,1249
FBgn0085292,CG34263,3L,265595,265908,313
FBgn0085294,CG34265,3L,3268461,3268994,533
FBgn0085298,CG34269,3L,528337,528996,659
FBgn0085302,CG34273,3R,14517042,14517487,445
FBgn0085305,CG34276,3R,15925629,15927577,1948
FBgn0085306,CG34277,3R,5369540,5371744,2204
FBgn0085308,CG34279,3R,17402362,17403288,926
FBgn0085315,CG34286,3R,19715186,19715927,741
FBgn0085316,CG34287,3R,5853332,5854282,950
FBgn0085317,CG34288,3R,22446763,22447263,500
FBgn0085320,CG34291,3R,26425290,26425781,491
FBgn0085322,CG34293,3R,27164708,27165575,867
FBgn0085325,CG34296,3R,29722538,29723013,475
FBgn0085329,CG34300,3R,30305808,30306640,832
FBgn0085330,CG34301,3R,8773435,8773810,375
FBgn0085334,CG34305,3R,4242785,4243146,361
FBgn0085337,CG34308,3R,13089242,13090081,839
FBgn0085339,CG34310,2L,6663664,6674780,11116
FBgn0085342,CG34313,2L,16879517,16886319,6802
FBgn0085343,Sws1,2L,2573436,2575052,1616
FBgn0085344,CG34315,2R,13202728,13206547,3819
FBgn0085345,CG34316,3R,15230585,15231686,1101
FBgn0085346,Rpp14a,3R,30056859,30058131,1272
FBgn0085350,inaF-C,X,11726390,11731765,5375
FBgn0085351,inaF-A,X,11726390,11733895,7505
FBgn0085353,CG34324,X,13456534,13457663,1129
FBgn0085354,CG34325,X,16714449,16721411,6962
FBgn0085356,CG34327,X,17222968,17223815,847
FBgn0085357,CG34328,X,18399569,18400065,496
FBgn0085359,CG34330,X,19068275,19068973,698
FBgn0085360,CG34331,X,20122453,20125271,2818
FBgn0085367,CG34338,X,7768737,7769161,424
FBgn0085369,Drgx,2L,3662745,3692114,29369
FBgn0085370,Pde11,2L,18532025,18590342,58317
FBgn0085371,CG34342,3L,5503528,5510860,7332
FBgn0085376,CG34347,3R,31311157,31371748,60591
FBgn0085377,CG34348,X,11339873,11344734,4861
FBgn0085380,dcma,2L,4694721,4722465,27744
FBgn0085382,CG34353,3R,27767966,27905843,137877
FBgn0085383,CG34354,3R,28146880,28240526,93646
FBgn0085384,CG34355,3R,23803859,23859167,55308
FBgn0085385,bma,3L,9908120,9967298,59178
FBgn0085386,CG34357,3R,4491943,4558067,66124
FBgn0085387,shakB,X,20761071,20927050,165979
FBgn0085390,Dgk,2R,7834812,7885982,51170
FBgn0085391,trv,3R,28026615,28090740,64125
FBgn0085395,Shawl,2L,9370309,9415156,44847
FBgn0085396,CG34367,2L,10347851,10353905,6054
FBgn0085397,Fili,2R,21872030,21946259,74229
FBgn0085399,CG34370,2R,21987068,22039559,52491
FBgn0085400,side-V,2R,23163012,23203973,40961
FBgn0085404,CG34375,3R,23000139,23010562,10423
FBgn0085405,CG34376,3R,22448099,22460749,12650
FBgn0085408,Shrm,2R,14308142,14351802,43660
FBgn0085409,smal,2L,6179133,6211114,31981
FBgn0085410,TrissinR,2L,5824004,5856767,32763
FBgn0085411,CG34382,3L,9878985,9884493,5508
FBgn0085412,kmr,3R,13715207,13764667,49460
FBgn0085413,CG34384,3R,7814361,7855392,41031
FBgn0085414,dpr12,2R,5804712,5860831,56119
FBgn0085415,CG34386,2R,18062415,18093628,31213
FBgn0085417,natalisin,3R,14418593,14421865,3272
FBgn0085419,Rgk2,2R,18539585,18548969,9384
FBgn0085420,DIP-delta,3L,5424109,5442399,18290
FBgn0085421,Epac,2R,6759715,6798941,39226
FBgn0085422,CG34393,2L,3175112,3200496,25384
FBgn0085423,GramD1B,2L,3358640,3373372,14732
FBgn0085424,nub,2L,12587625,12628135,40510
FBgn0085425,CG34396,2R,21092222,21101453,9231
FBgn0085426,Rgk3,2R,21255165,21280995,25830
FBgn0085427,CG34398,2L,8898786,8933594,34808
FBgn0085428,Nox,2R,16307269,16316485,9216
FBgn0085430,Dora,X,18863950,18884075,20125
FBgn0085431,Sol1,3R,12386249,12402902,16653
FBgn0085432,pan,4,69326,114270,44944
FBgn0085433,CG34404,3R,15363786,15367665,3879
FBgn0085434,NaCP60E,2R,24891614,24921677,30063
FBgn0085436,Not1,2R,9566146,9579007,12861
FBgn0085437,CG34408,X,10220110,10230088,9978
FBgn0085438,CG34409,3R,9742877,9746367,3490
FBgn0085440,Lgr4,X,13161714,13189164,27450
FBgn0085442,NKAIN,2R,24881570,24888615,7045
FBgn0085443,spri,X,10490069,10585422,95353
FBgn0085444,mute,2R,16948296,16955266,6970
FBgn0085446,CG34417,X,6540771,6589173,48402
FBgn0085447,sif,3L,5657913,5749599,91686
FBgn0085450,Snoo,2L,7891187,7984196,93009
FBgn0085451,htk,X,18843663,18855858,12195
FBgn0085452,CG34423,2R,23358612,23359204,592
FBgn0085453,Mthfs,2R,23359215,23360266,1051
FBgn0085454,CG34425,3R,4504612,4506365,1753
FBgn0085465,CG34436,3R,28282580,28283548,968
FBgn0085466,CG34437,3R,28283719,28284725,1006
FBgn0085468,ND-MWFE,2R,13158666,13160190,1524
FBgn0085470,lmgB,2L,8524999,8528618,3619
FBgn0085474,CG34445,2R,22647892,22648478,586
FBgn0085475,CG34446,2R,22647458,22647807,349
FBgn0085478,Zdhhc8,X,9324508,9356227,31719
FBgn0085479,CG34450,X,9329016,9330487,1471
FBgn0085480,CG34451,3L,15688517,15692068,3551
FBgn0085481,CG34452,3L,15686352,15687902,1550
FBgn0085482,CG34453,3L,232480,233351,871
FBgn0085483,CG34454,3L,231681,232350,669
FBgn0085484,Pdxk,3L,9360316,9362042,1726
FBgn0085485,CG34456,3L,9362108,9362734,626
FBgn0085486,CG34457,2R,16670326,16671836,1510
FBgn0085488,CG34459,2R,16824664,16826648,1984
FBgn0085489,CG34460,2R,16826872,16827755,883
FBgn0085512,RYa,2R,3647346,3647765,419
FBgn0085732,CR40190,2R,1211067,1213666,2599
FBgn0085786,CR41501,2R,3524536,3526047,1511
FBgn0085638,CG41378,2R,2770380,2846708,76328
FBgn0085582,lncRNA:CR41257,2R,1070657,1071319,662
FBgn0085810,CR41597,3L,24553110,24554200,1090
FBgn0085736,CG40472,3L,24927130,24927710,580
FBgn0085612,CR41320,3L,26165235,26178793,13558
FBgn0085599,CG41284,3L,26298455,26305572,7117
FBgn0085819,28SrRNA-Psi:CR41609,X,23261772,23262666,894
FBgn0085771,28SrRNA-Psi:CR40741,X,23239718,23240975,1257
FBgn0085802,18SrRNA:CR41548,rDNA,43484,45478,1994
FBgn0085753,28SrRNA-Psi:CR40596,rDNA,16936,22940,6004
FBgn0085734,CR40450,3L,25403776,25405940,2164
FBgn0085813,18SrRNA-Psi:CR41602,X,23211192,23213166,1974
FBgn0086028,snoRNA:Me28S-G2173,2R,22606795,22606861,66
FBgn0086039,snoRNA:Me28S-A2113,2L,19008611,19008683,72
FBgn0086042,snoRNA:Me28S-G980,X,1482559,1482629,70
FBgn0086048,snoRNA:Me28S-U3344b,X,21050898,21050978,80
FBgn0086051,snoRNA:Me28S-U2134a,3R,5625367,5625441,74
FBgn0086054,snoRNA:Me18S-G1358b,3R,9355313,9355387,74
FBgn0086055,snoRNA:Me18S-C1096,3R,11222405,11222489,84
FBgn0086056,snoRNA:Me18S-A425,3R,11222841,11222924,83
FBgn0086057,snoRNA:Me28S-G2017,3R,11224308,11224400,92
FBgn0086061,snoRNA:Or-CD8,3R,29862626,29862717,91
FBgn0086063,snoRNA:Me28S-C788a,3L,827312,827383,71
FBgn0086067,snoRNA:Me28S-A771,3L,830437,830511,74
FBgn0086068,snoRNA:Or-CD12,3L,3221350,3221427,77
FBgn0086069,snoRNA:Me28S-C3351,3L,3221771,3221847,76
FBgn0086071,snoRNA:Or-CD11b,3L,3222263,3222329,66
FBgn0086072,snoRNA:Or-CD11a,3L,3222475,3222541,66
FBgn0086075,snoRNA:Me28S-G3253,3L,9510720,9510807,87
FBgn0086078,snoRNA:Me28S-A774b,3L,13023580,13023652,72
FBgn0086079,snoRNA:Me28S-A774a,3L,13024226,13024298,72
FBgn0086129,snama,2R,24086604,24092014,5410
FBgn0086130,Dbp21E2,2L,811584,813380,1796
FBgn0086134,Prosalpha2,3R,12431321,12432556,1235
FBgn0086251,del,2L,21145137,21148546,3409
FBgn0086253,rumi,3R,22749014,22750597,1583
FBgn0086254,Akr1B,3L,11620535,11624381,3846
FBgn0086266,Vm26Ac,2L,5958005,5958631,626
FBgn0086346,ALiX,3R,27696466,27700110,3644
FBgn0086347,Myo31DF,2L,10491814,10506779,14965
FBgn0086348,se,3L,8520552,8521489,937
FBgn0086350,tef,2R,17054546,17056835,2289
FBgn0086355,Tpi,3R,30132981,30134599,1618
FBgn0086356,tum,2R,13856150,13858689,2539
FBgn0086357,Sec61alpha,2L,6477182,6480575,3393
FBgn0086358,Tab2,2R,19292529,19304508,11979
FBgn0086359,Invadolysin,3R,10144668,10159134,14466
FBgn0086361,alph,3R,29591831,29617157,25326
FBgn0086362,spn-F,3R,31255127,31256659,1532
FBgn0086365,Orct2,3R,24273029,24275728,2699
FBgn0086367,t,X,9217655,9223257,5602
FBgn0086368,tw,X,784746,788215,3469
FBgn0086370,sra,3R,16186999,16197584,10585
FBgn0086371,Elp6,3R,13361816,13366910,5094
FBgn0086372,lap,3R,7186994,7200941,13947
FBgn0086378,Alg-2,3R,3623143,3627690,4547
FBgn0086384,Mer,X,19689697,19693500,3803
FBgn0086408,stl,2R,22807860,22815993,8133
FBgn0086442,mib2,2L,19034444,19041541,7097
FBgn0086443,AsnRS,2L,19129469,19131954,2485
FBgn0086444,l(2)37Cb,2L,19123998,19126976,2978
FBgn0086445,l(2)37Cd,2L,19127260,19129326,2066
FBgn0086446,DCTN6-p27,2L,19132323,19133097,774
FBgn0086447,Polr1D,2L,19133023,19135233,2210
FBgn0086448,PIG-Q,X,16359143,16361275,2132
FBgn0086450,su(r),X,9196808,9201820,5012
FBgn0086451,l(2)k09022,2L,6854142,6860849,6707
FBgn0086472,RpS25,3R,11215028,11216287,1259
FBgn0086519,Cpr47Eg,2R,11277957,11278445,488
FBgn0086532,Spt-I,2R,13168498,13170744,2246
FBgn0086533,snoRNA:Me18S-C419,3L,27267954,27268023,69
FBgn0086558,Ubi-p5E,X,6276876,6279647,2771
FBgn0086601,snoRNA:Psi28S-3327c,3L,13043371,13043510,139
FBgn0086602,snoRNA:Psi28S-3436b,X,6742349,6742491,142
FBgn0086603,snoRNA:Or-CD2,2R,9097030,9097169,139
FBgn0086604,side-VIII,2R,20424338,20478951,54613
FBgn0086605,CG9853,3R,4398381,4402027,3646
FBgn0086608,CG34112,3R,4391711,4394259,2548
FBgn0086611,Lcp65Ag3,3L,6130386,6130989,603
FBgn0086655,jing,2R,6502006,6621792,119786
FBgn0086656,shrb,2R,9142146,9143914,1768
FBgn0086657,IKKepsilon,2L,20676045,20678979,2934
FBgn0086660,snoRNA:Psi28S-1837a,3L,5764258,5764394,136
FBgn0086661,snoRNA:Psi28S-2566,3L,18896189,18896456,267
FBgn0086662,snoRNA:Psi28S-3186,3R,5598015,5598157,142
FBgn0086663,snoRNA:Psi18S-1275,3R,9778398,9778537,139
FBgn0086664,snoRNA:Psi28S-2149,3R,30206783,30206926,143
FBgn0086665,snoRNA:Psi18S-1377a,3R,30207745,30207883,138
FBgn0086666,snoRNA:Psi28S-2179,X,763942,764086,144
FBgn0086668,snoRNA:Psi28S-3436a,X,6742686,6742826,140
FBgn0086669,snoRNA:Psi18S-841a,2R,21327056,21327199,143
FBgn0086671,snoRNA:Psi28S-2876,X,17144831,17144970,139
FBgn0086672,snoRNA:Or-aca5,2R,9095685,9095832,147
FBgn0086673,CG13272,2L,16804884,16816069,11185
FBgn0086674,Tpst,X,13563823,13593224,29401
FBgn0086675,fne,X,12917477,12950417,32940
FBgn0086676,spin,2R,16124981,16138238,13257
FBgn0086677,jeb,2R,12085194,12119340,34146
FBgn0086679,p,3R,8660903,8670684,9781
FBgn0086680,vvl,3L,6790158,6794941,4783
FBgn0086681,Mst36Fa,2L,18675183,18676998,1815
FBgn0086683,Spf45,2L,23066874,23068386,1512
FBgn0085407,Pvf3,2L,7098188,7157695,59507
FBgn0086686,l(3)L1231,3R,14642672,14655716,13044
FBgn0086687,Desat1,3R,12439600,12447616,8016
FBgn0086690,Plp,3L,15066081,15094724,28643
FBgn0086691,UK114,2L,15274181,15275091,910
FBgn0086693,iav,X,6813978,6818156,4178
FBgn0086694,Bre1,3L,5789831,5794192,4361
FBgn0086695,hd,3R,5372592,5374962,2370
FBgn0086698,frtz,2L,1711302,1715851,4549
FBgn0086704,stops,3R,31158156,31169106,10950
FBgn0086706,pix,3L,8972056,8974765,2709
FBgn0086707,ncm,2L,18444507,18448957,4450
FBgn0086708,stv,3L,13477541,13483515,5974
FBgn0086710,RpL30,2L,19008031,19009306,1275
FBgn0086711,mol,2L,14975747,14997559,21812
FBgn0086712,Egm,2R,11616869,11619023,2154
FBgn0086757,Golgin97,2R,13450586,13453393,2807
FBgn0086758,chinmo,2L,1651258,1704682,53424
FBgn0086768,Pcmt,3R,5552823,5554316,1493
FBgn0086778,nAChRalpha7,X,19327075,19348447,21372
FBgn0086779,step,2L,21740041,21757466,17425
FBgn0086782,amn,X,19886108,19890060,3952
FBgn0086784,stmA,2R,8729502,8734304,4802
FBgn0086785,Vps36,3L,13511646,13513112,1466
FBgn0086855,CG17078,2L,274740,278234,3494
FBgn0086856,CG11555,2L,273836,274766,930
FBgn0086895,pea,2R,14153153,14157106,3953
FBgn0086898,dgo,2R,10816037,10819884,3847
FBgn0086904,Nacalpha,2R,12759693,12760999,1306
FBgn0086906,sls,3L,2039681,2115611,75930
FBgn0086907,Cyt-c-d,2L,16715891,16719635,3744
FBgn0086908,egg,2R,24775534,24779901,4367
FBgn0086909,CG31751,2L,18677221,18683715,6494
FBgn0086912,mbm,2L,271912,273715,1803
FBgn0086913,Rab26,3L,21318774,21335027,16253
FBgn0086915,Mst77F,3L,20816901,20818027,1126
FBgn0086917,spok,3R,3322810,3354486,31676
FBgn0087002,apolpp,4,1060969,1077273,16304
FBgn0087005,rtp,3R,5236092,5237315,1223
FBgn0087007,bbg,3L,14412828,14536276,123448
FBgn0087008,e(y)3,X,19626548,19638369,11821
FBgn0087011,CG41520,2R,1649061,1778937,129876
FBgn0087012,5-HT2A,3R,4612870,4633304,20434
FBgn0087013,Karybeta3,3R,4649176,4654624,5448
FBgn0087021,Spc25,3R,12961745,12963249,1504
FBgn0087035,AGO2,3L,15554113,15561042,6929
FBgn0087039,Sbp2,3L,8304157,8305325,1168
FBgn0087040,alphaTub67C,3L,9681268,9683370,2102
FBgn0087041,Hyls1,2L,16342430,16352628,10198
FBgn0243486,rdo,2L,18012380,18070246,57866
FBgn0243511,psidin,3R,20021704,20026482,4778
FBgn0243512,puc,3R,8105332,8122294,16962
FBgn0243513,cnir,2L,3038826,3039812,986
FBgn0243514,eater,3R,27095867,27099679,3812
FBgn0243516,Vrp1,2R,22106107,22122562,16455
FBgn0243586,Tb,3R,26656440,26657531,1091
FBgn0250732,gfzf,3R,7145880,7150968,5088
FBgn0250746,Prosbeta7,3R,5357012,5358364,1352
FBgn0250753,kra,3R,5595364,5601136,5772
FBgn0250754,CG42232,3R,16458280,16469663,11383
FBgn0250755,CG42233,3R,31799634,31805278,5644
FBgn0250757,kumpel,3R,25907022,25921046,14024
FBgn0250785,vari,2L,20788662,20797042,8380
FBgn0250786,Chd1,2L,2979562,2987723,8161
FBgn0250788,beta-Spec,X,17657372,17669371,11999
FBgn0250789,alpha-Spec,3L,1778485,1795328,16843
FBgn0250791,alphaSnap,3L,20313632,20316577,2945
FBgn0250814,UQCR-C2,3L,16584124,16586111,1987
FBgn0250815,Jon65Aiv,3L,6039155,6040135,980
FBgn0250816,AGO3,3L,23554593,23689640,135047
FBgn0250819,CG33521,4,1185768,1192985,7217
FBgn0250820,meigo,3R,21138270,21140365,2095
FBgn0250821,CG14644,3R,4251894,4253043,1149
FBgn0250822,CG34222,2R,10319844,10320500,656
FBgn0250823,gish,3R,16272452,16304768,32316
FBgn0250824,CG33655,2R,21317793,21320017,2224
FBgn0250825,CG34241,3L,12127979,12128461,482
FBgn0250826,CG34160,2L,10579753,10580324,571
FBgn0250830,CG12547,2R,4785855,4788965,3110
FBgn0250833,CG34461,3L,8325859,8328307,2448
FBgn0250834,CG33308,2L,14802334,14803293,959
FBgn0250835,CG15394,2L,2591869,2592773,904
FBgn0250837,dUTPase,2L,11011312,11012135,823
FBgn0250838,roh,2R,23385464,23386463,999
FBgn0250839,Jhbp2,3R,4956999,4961351,4352
FBgn0250843,Prosalpha6,2L,10221351,10222546,1195
FBgn0250844,CG4218,2L,14547498,14549109,1611
FBgn0250845,CG1288,3R,7206652,7208431,1779
FBgn0250846,glob2,3R,6605997,6608914,2917
FBgn0250847,CG14034,2L,5215189,5216542,1353
FBgn0250848,CtsK1,3L,13994231,13996571,2340
FBgn0250850,rig,2R,20633876,20640681,6805
FBgn0250851,CG33981,2R,17773964,17781930,7966
FBgn0250862,CG42237,X,13115131,13123066,7935
FBgn0250867,CG42238,2L,20965520,21052164,86644
FBgn0250868,CG42239,2R,17572829,17573330,501
FBgn0250869,CG42240,X,6330842,6333028,2186
FBgn0250871,pot,X,11907409,11917260,9851
FBgn0250874,ttm50,X,2730077,2732190,2113
FBgn0250903,lmgA,2L,8524999,8528618,3619
FBgn0250904,CG34434,X,5614554,5616370,1816
FBgn0250906,Pgk,2L,2746880,2753068,6188
FBgn0250907,Cht10,2L,22999574,23025915,26341
FBgn0250908,beat-VII,3R,26645282,26681966,36684
FBgn0250910,Octbeta3R,3R,12511570,12548229,36659
FBgn0250911,CG42245,3L,2631715,2641984,10269
FBgn0259098,CG42246,X,7411267,7411906,639
FBgn0259099,DCX-EMAP,3L,14903805,14942907,39102
FBgn0259101,CG42249,X,11096273,11108148,11875
FBgn0259108,futsch,X,1409069,1453686,44617
FBgn0259110,mmd,X,15946936,15973159,26223
FBgn0259111,Ndae1,2L,7223328,7249343,26015
FBgn0259112,asRNA:CR42254,2R,14769599,14771295,1696
FBgn0259113,PolA1,3R,21666562,21671750,5188
FBgn0259139,glo,3R,11815206,11819420,4214
FBgn0259140,Cubn2,3L,11801951,11814755,12804
FBgn0259143,CG42258,X,12463528,12478431,14903
FBgn0259145,CG42260,2R,22740999,22798289,57290
FBgn0259146,fid,3R,25970080,25982736,12656
FBgn0259150,OtopLc,X,5650567,5662861,12294
FBgn0259151,CG42266,2L,16337989,16340368,2379
FBgn0259152,Clbn,3R,25127502,25131155,3653
FBgn0259162,RunxB,X,20538497,20567097,28600
FBgn0259163,CG42268,3L,9734012,9760395,26383
FBgn0259164,CG42269,3L,6066296,6071545,5249
FBgn0259166,CG42271,X,14228060,14234066,6006
FBgn0259167,CG42272,3L,5803033,5805749,2716
FBgn0259168,mnb,X,17862697,17887222,24525
FBgn0259170,alpha-Man-Ia,X,10266792,10325958,59166
FBgn0259171,Pde9,X,12785563,12897327,111764
FBgn0259173,corn,3L,7142991,7157073,14082
FBgn0259174,Nedd4,3L,17530081,17546660,16579
FBgn0259175,ome,3L,14672839,14747868,75029
FBgn0259176,bun,2L,12455540,12546611,91071
FBgn0259178,5PtaseI,3R,25040427,25045151,4724
FBgn0259179,CG42284,2R,22821430,22828903,7473
FBgn0259187,Ir60d,2R,24519423,24521147,1724
FBgn0259192,CG42296,2L,2032519,2036041,3522
FBgn0259193,Ir94d,3R,23402808,23405139,2331
FBgn0259194,Ir94e,3R,23405509,23407402,1893
FBgn0259195,CG42299,X,15574947,15575683,736
FBgn0259196,CG42300,X,15555253,15556045,792
FBgn0259198,CG42302,X,18724914,18725672,758
FBgn0259199,Snup,3L,2652088,2655455,3367
FBgn0259200,CG42304,3L,2652088,2655455,3367
FBgn0259201,CG42305,2L,18812648,18813941,1293
FBgn0259202,CG42306,2R,18658418,18661548,3130
FBgn0259203,CG42307,3L,7329132,7333471,4339
FBgn0259204,sloth2,X,7011357,7012137,780
FBgn0259209,Mlp60A,2R,24074602,24078223,3621
FBgn0259210,prom,2R,24415410,24428387,12977
FBgn0259211,grh,2R,17801132,17842820,41688
FBgn0259212,cno,3R,5170004,5217456,47452
FBgn0259213,side-II,2L,14907489,14972300,64811
FBgn0259214,PMCA,4,328193,358917,30724
FBgn0259215,Ir93a,3R,20851709,20859945,8236
FBgn0259216,RhoGAP102A,4,254997,265574,10577
FBgn0259219,CG42319,2R,13260101,13266336,6235
FBgn0259221,ATP8A,2R,13414978,13439051,24073
FBgn0259222,CG42322,3R,20740108,20756639,16531
FBgn0259223,CG42323,X,18422413,18427001,4588
FBgn0259224,CG42324,3L,3472447,3510895,38448
FBgn0259226,CG42326,2R,8573368,8584779,11411
FBgn0259227,CG42327,3R,11656149,11673974,17825
FBgn0259228,C3G,X,6780790,6803593,22803
FBgn0259229,CG42329,2L,1219293,1229802,10509
FBgn0259231,CCKLR-17D1,X,18707494,18726572,19078
FBgn0259233,CG42331,3R,24772181,24784562,12381
FBgn0259236,comm3,3L,15613184,15647762,34578
FBgn0259238,CG42336,2R,11294536,11297520,2984
FBgn0259239,CG42337,3L,21183313,21193363,10050
FBgn0259241,vex,X,10967722,11039901,72179
FBgn0259242,CG42340,X,6423123,6524323,101200
FBgn0259243,Pka-R1,3L,20816118,20836048,19930
FBgn0259244,CG42342,3R,16502770,16571363,68593
FBgn0259245,DIP-beta,X,21422115,21457738,35623
FBgn0259246,brp,2R,9503765,9541565,37800
FBgn0259481,Mob2,3L,11522757,11562233,39476
FBgn0259482,Mob3,2L,10265336,10266570,1234
FBgn0259483,Mob4,2R,6695114,6696661,1547
FBgn0259676,Prim2,3L,20359833,20361585,1752
FBgn0259677,CG42346,X,22832399,22885541,53142
FBgn0259678,sqa,2R,9716348,9748121,31773
FBgn0259682,Jabba,2R,18757074,18761082,4008
FBgn0259683,Ir40a,2L,22189526,22214376,24850
FBgn0259685,crb,3R,24295078,24314541,19463
FBgn0259699,CG42353,X,16093059,16104946,11887
FBgn0259700,CG42354,X,16093059,16104946,11887
FBgn0259703,Grl62a,3L,2020554,2021958,1404
FBgn0259704,Nsun5,3R,19160099,19162300,2201
FBgn0259705,CG42359,3R,19161259,19162300,1041
FBgn0259707,CG42361,2R,24607673,24608788,1115
FBgn0259708,CG42362,2R,21664126,21666108,1982
FBgn0259709,CG42363,2R,21664126,21666108,1982
FBgn0259710,CG42364,2R,21665940,21666579,639
FBgn0259711,CG42365,2R,21666687,21667594,907
FBgn0259712,CG42366,2L,9925161,9930378,5217
FBgn0259713,CG42367,2L,9930580,9931131,551
FBgn0259714,DIP-epsilon,2L,6377771,6411326,33555
FBgn0259715,CG42369,2L,6395853,6397249,1396
FBgn0259716,Nepl6,2L,6383435,6385512,2077
FBgn0259717,CG42371,2L,2216503,2217246,743
FBgn0259718,CG42372,2R,16291453,16292269,816
FBgn0259720,CG42374,3L,19263766,19266838,3072
FBgn0259721,CG42375,3R,13779624,13780795,1171
FBgn0259722,CG42376,X,254876,255524,648
FBgn0259725,CG42379,2R,21667541,21669916,2375
FBgn0259726,CG42380,2R,21667541,21669916,2375
FBgn0259727,CG42381,2R,21667541,21669916,2375
FBgn0259728,CG42382,2R,9166566,9167508,942
FBgn0259729,CG42383,2R,24423926,24425102,1176
FBgn0259730,tal-1A,3R,13813109,13814648,1539
FBgn0259731,tal-2A,3R,13813109,13814648,1539
FBgn0259732,tal-3A,3R,13813109,13814648,1539
FBgn0259733,tal-AA,3R,13813109,13814648,1539
FBgn0259734,Nost,X,9030205,9054575,24370
FBgn0259735,mtgo,2L,16545016,16663218,118202
FBgn0259736,CG42390,3R,22120061,22133367,13306
FBgn0259737,CG42391,2R,15202193,15202987,794
FBgn0259738,CG42392,2R,16765361,16766000,639
FBgn0259739,CG42393,3L,18042733,18044214,1481
FBgn0259740,CG42394,3R,10849825,10851788,1963
FBgn0259741,CG42395,X,9575126,9576247,1121
FBgn0259742,CG42360,2R,24607267,24610847,3580
FBgn0259745,wech,2R,7478853,7489823,10970
FBgn0259748,CG42397,3L,11973085,11973790,705
FBgn0259749,mmy,2L,6468538,6473904,5366
FBgn0259785,pzg,3L,21286099,21290310,4211
FBgn0259789,zld,X,19766465,19783548,17083
FBgn0259794,sinah,3L,16859080,16860529,1449
FBgn0259795,loopin-1,2R,16534943,16537086,2143
FBgn0259818,CG42399,2L,144231,153300,9069
FBgn0259821,CG42402,3R,4077939,4104326,26387
FBgn0259823,CG42404,3R,15250094,15257765,7671
FBgn0259824,Hip14,3L,15988236,15992464,4228
FBgn0259831,CG34309,3R,13372630,13373326,696
FBgn0259832,CG34229,2R,11841608,11842164,556
FBgn0259834,out,X,19310513,19322106,11593
FBgn0259849,Su(Ste):CR42418,211000022278436,1551,2815,1264
FBgn0259876,Cap-G,2R,13133142,13142820,9678
FBgn0259878,Fs,2R,15223560,15241589,18029
FBgn0259896,NimC1,2L,13973158,13976769,3611
FBgn0259916,CG42445,3L,8154681,8158900,4219
FBgn0259917,CG42446,3R,16358144,16360108,1964
FBgn0259918,inaF-B,X,11724668,11732770,8102
FBgn0259923,Septin4,X,16684216,16695173,10957
FBgn0259926,CG42449,X,5683240,5684456,1216
FBgn0259927,CG42450,X,18813297,18830406,17109
FBgn0259932,CG42455,3L,9972312,9974023,1711
FBgn0259933,Dpm2,3L,3319555,3322489,2934
FBgn0259935,CG42458,3L,7423827,7454717,30890
FBgn0259936,Uhg3,2L,20647533,20648848,1315
FBgn0259937,Nop60B,2R,24174877,24186343,11466
FBgn0259938,cwo,3R,10388258,10400752,12494
FBgn0259952,Sfp24Bb,2L,3669261,3669775,514
FBgn0259954,CG42464,2L,3699464,3699826,362
FBgn0259964,Sfp33A3,2L,11839912,11840329,417
FBgn0259968,Sfp60F,2R,25172245,25172695,450
FBgn0259975,Sfp87B,3R,12273126,12273521,395
FBgn0259977,Tdc1,2R,6677001,6680391,3390
FBgn0259978,vlc,2R,5702112,5705439,3327
FBgn0259982,Uxt,2L,15256581,15257642,1061
FBgn0259984,kuz,2L,13550139,13639411,89272
FBgn0259985,Mppe,2R,12025614,12027707,2093
FBgn0259989,CG42486,2L,11843137,11844063,926
FBgn0259990,CG42487,3R,27957356,27959245,1889
FBgn0259991,CG42488,3R,25483098,25485481,2383
FBgn0259992,CG42489,3R,8653802,8654766,964
FBgn0259993,lncRNA:CR42491,X,762615,763810,1195
FBgn0259994,OtopLa,X,5625676,5648487,22811
FBgn0259998,CG17571,2L,20255988,20257192,1204
FBgn0260002,snoRNA:Me28S-U2134b,3R,5625178,5625254,76
FBgn0260003,Dys,3R,19461085,19597288,136203
FBgn0260004,Snmp1,3R,21165167,21168205,3038
FBgn0260005,wtrw,3R,7891331,7901147,9816
FBgn0260006,drd,X,15125753,15137311,11558
FBgn0260007,CG42493,2R,11778526,11779235,709
FBgn0260008,UQCR-11,3L,25120709,25126171,5462
FBgn0260011,NimC4,2L,14047582,14048863,1281
FBgn0260012,pds5,2R,12027985,12033725,5740
FBgn0260026,CG42494,3L,3184404,3186549,2145
FBgn0260027,CG42495,3L,18667361,18668135,774
FBgn0260049,flr,3L,13412843,13416453,3610
FBgn0260222,CG42496,2R,21691295,21692764,1469
FBgn0260223,CG42497,2R,21690215,21691139,924
FBgn0260224,Tcs6,3R,26057347,26058223,876
FBgn0260225,CR42499,X,3793464,3794660,1196
FBgn0260228,CG42502,2L,18808694,18811252,2558
FBgn0260229,Mocs2A,3R,25125632,25127359,1727
FBgn0260233,CG42507,3L,14747929,14757962,10033
FBgn0260234,Xport-B,3R,19914320,19915412,1092
FBgn0260237,BBIP1,3R,9404385,9407857,3472
FBgn0260238,CG42512,X,16651376,16653275,1899
FBgn0260243,E(var)3-9,3R,8990645,8992949,2304
FBgn0260386,mtg,3R,8250497,8260718,10221
FBgn0260388,CG42514,3L,16491838,16496236,4398
FBgn0260390,CG42516,2R,8129354,8131323,1969
FBgn0260392,CG42518,2R,18167227,18168380,1153
FBgn0260397,Su(var)3-3,3L,20226381,20230250,3869
FBgn0260398,Pbp49,2R,8129354,8131323,1969
FBgn0260399,gwl,3R,18746370,18750360,3990
FBgn0260400,elav,X,509235,523226,13991
FBgn0260401,MED9,2R,18167255,18168380,1125
FBgn0260407,mRpS23,2L,13834250,13835072,822
FBgn0260428,CG42523,2L,4762895,4763951,1056
FBgn0260429,CG42524,2R,15613854,15657214,43360
FBgn0260431,CG42526,3L,9433686,9435399,1713
FBgn0260435,CR42530,2L,23320508,23324192,3684
FBgn0260486,Ziz,2L,7472513,7496307,23794
FBgn0260487,CG42534,3R,27340622,27372574,31952
FBgn0260499,qvr,2R,11442505,11451604,9099
FBgn0260632,dl,2L,17436830,17450364,13534
FBgn0260634,eIF4G2,3R,23808285,23819237,10952
FBgn0260635,Diap1,3L,16038410,16051034,12624
FBgn0260639,gammaTub23C,2L,2972891,2974858,1967
FBgn0260642,Antp,3R,6896253,6999228,102975
FBgn0260648,Rrp40,2L,1728732,1729762,1030
FBgn0260653,serp,3L,19700977,19708015,7038
FBgn0260655,l(3)76BDm,3L,19613427,19618521,5094
FBgn0260657,CG42540,3L,4556087,4592295,36208
FBgn0260658,CG42541,X,3891497,3930578,39081
FBgn0260659,CG42542,3R,15196598,15203074,6476
FBgn0260660,Mp,3L,6998843,7053499,54656
FBgn0260719,CR42546,2L,21589784,21590593,809
FBgn0260720,asRNA:CR42547,2R,21631421,21634040,2619
FBgn0260722,lncRNA:CR42549,3R,9548104,9551806,3702
FBgn0260741,CG3281,3R,11960883,11962805,1922
FBgn0260742,CG12213,3R,11964674,11967691,3017
FBgn0260743,GC1,3R,11967708,11971686,3978
FBgn0260744,Tango9,3R,11971007,11974910,3903
FBgn0260745,mfas,3R,11984862,11993315,8453
FBgn0260746,Ect3,3R,11999278,12003516,4238
FBgn0260747,Chchd2,X,17149001,17150647,1646
FBgn0260748,CG5004,X,17107582,17135988,28406
FBgn0260749,Utx,2L,10272325,10278811,6486
FBgn0260750,Mulk,2L,10270051,10271465,1414
FBgn0260753,Pdfr,X,2552206,2578640,26434
FBgn0260755,CG42553,3L,834093,835515,1422
FBgn0260756,CG42554,3L,835683,836770,1087
FBgn0260758,CG42556,2L,16889908,16891239,1331
FBgn0260759,CG42557,3R,29933287,29934587,1300
FBgn0260760,CG42558,3R,29933287,29934587,1300
FBgn0260763,CG42561,2R,17684855,17685548,693
FBgn0260764,CG42562,2R,17685814,17686410,596
FBgn0260766,CG42564,3R,6374475,6377348,2873
FBgn0260767,CG42565,2R,22657901,22661389,3488
FBgn0260768,CG42566,2R,22661934,22663241,1307
FBgn0260770,CG42568,2R,24157668,24159312,1644
FBgn0260771,Larp7,X,9243817,9245925,2108
FBgn0260775,DnaJ-60,2R,24157668,24159312,1644
FBgn0260776,CG42570,3L,15717819,15720073,2254
FBgn0260777,CG42571,3L,15716453,15717749,1296
FBgn0260779,GatA,3R,19026174,19028857,2683
FBgn0260780,wisp,X,11893943,11899920,5977
FBgn0260789,mxc,X,9236801,9243467,6666
FBgn0260793,2mit,3R,13121951,13155687,33736
FBgn0260794,ctrip,3R,4786284,4812096,25812
FBgn0260795,NaPi-III,3L,11123348,11134663,11315
FBgn0260798,Gprk1,2R,4322295,4471060,148765
FBgn0260799,p120ctn,2R,4595288,4609492,14204
FBgn0260812,inaF-D,X,11724668,11729099,4431
FBgn0260817,gkt,2L,3159950,3162399,2449
FBgn0260855,Sec22,X,806076,808200,2124
FBgn0260856,Membrin,3L,5366455,5367381,926
FBgn0260857,Bet1,3L,19261394,19262437,1043
FBgn0260858,Ykt6,X,7920409,7921966,1557
FBgn0260859,Bet3,3L,9438482,9442267,3785
FBgn0260860,Bet5,3R,30180232,30181486,1254
FBgn0260861,Trs23,2L,8686231,8687052,821
FBgn0260862,Vti1a,3L,691486,692919,1433
FBgn0260866,dnr1,2R,22563152,22592964,29812
FBgn0260868,CG42578,X,20446371,20446703,332
FBgn0260874,Ir76a,3L,19799278,19803427,4149
FBgn0260932,cuff,2R,11886067,11887603,1536
FBgn0260933,rempA,2L,553742,560310,6568
FBgn0260934,par-1,2R,19456170,19485686,29516
FBgn0260935,Vps15,3R,9240757,9245869,5112
FBgn0260936,scny,3L,5769002,5776271,7269
FBgn0260938,tay,X,15876368,15887311,10943
FBgn0260940,lsn,3R,21865168,21866238,1070
FBgn0260941,app,3L,12206238,12266841,60603
FBgn0260942,bond,3R,22550680,22556494,5814
FBgn0260943,Rbp6,3L,17058774,17238212,179438
FBgn0260944,Rbp1,3R,10784383,10786465,2082
FBgn0260945,Atg1,3L,12784429,12805116,20687
FBgn0260954,CG42586,2L,14741161,14741840,679
FBgn0260959,MCPH1,2R,11895997,11903918,7921
FBgn0260960,Baldspot,3L,16648442,16661615,13173
FBgn0260962,pic,3R,13052245,13056725,4480
FBgn0260964,Vmat,2R,13513132,13534251,21119
FBgn0260965,CG42588,3L,12814254,12824650,10396
FBgn0260970,Ubr3,X,7935896,7953883,17987
FBgn0260971,CG42594,X,4840833,4906575,65742
FBgn0260972,alc,2R,9135375,9137933,2558
FBgn0260985,RfC4,3L,4134860,4136038,1178
FBgn0260986,mei-38,X,1477063,1481420,4357
FBgn0260987,vtd,3L,27136525,27157999,21474
FBgn0260990,yata,3R,29749219,29754528,5309
FBgn0260991,Incenp,2R,7278467,7281795,3328
FBgn0260995,dpr21,2R,3066499,3191011,124512
FBgn0260997,CG42598,3L,26354140,26371356,17216
FBgn0261004,asl,3R,5603236,5606543,3307
FBgn0261015,Pif1A,3R,8774286,8801176,26890
FBgn0261016,clos,2R,9587953,9599732,11779
FBgn0261019,moi,3R,18255530,18257677,2147
FBgn0261020,wol,2L,8301345,8302985,1640
FBgn0261041,stj,2R,13805794,13819571,13777
FBgn0261046,Dscam3,3R,17473935,17505667,31732
FBgn0261049,Vps45,3R,9563924,9566092,2168
FBgn0261053,Cad86C,3R,10827079,10849030,21951
FBgn0261055,Sfp26Ad,2L,5942623,5943304,681
FBgn0261058,Sfp38D,2L,20640917,20642216,1299
FBgn0261064,Rbsn-5,2L,8159832,8161800,1968
FBgn0261065,Cpsf73,3R,18661121,18663552,2431
FBgn0261067,LSm1,2R,21169969,21170672,703
FBgn0261068,LSm7,2L,16742315,16743100,785
FBgn0261085,Syt12,X,13359248,13368179,8931
FBgn0261086,Syt14,3R,4314455,4319069,4614
FBgn0261089,Sytalpha,2L,17592260,17604387,12127
FBgn0261090,Sytbeta,3L,15014695,15064977,50282
FBgn0261108,Atg13,3R,8349815,8352817,3002
FBgn0261109,mrn,3L,15578769,15580537,1768
FBgn0261111,BHD,3L,7238542,7240245,1703
FBgn0261112,APP-BP1,3L,11098412,11100578,2166
FBgn0261113,Xrp1,3R,18914968,18926989,12021
FBgn0261119,Prp19,2R,18447361,18451041,3680
FBgn0261238,Alh,3R,7094596,7124185,29589
FBgn0261239,Hr39,2L,21237250,21259675,22425
FBgn0261243,Psa,3L,1502843,1523380,20537
FBgn0261244,inaE,X,13783714,13811493,27779
FBgn0261245,sing,X,16679297,16681784,2487
FBgn0261258,rgn,3L,21382501,21424416,41915
FBgn0261260,mgl,X,9358496,9500129,141633
FBgn0261261,plx,3R,5685855,5712837,26982
FBgn0261262,CG42613,3R,18929196,18978088,48892
FBgn0261266,zuc,2L,11988735,11989882,1147
FBgn0261267,CG42615,2R,8737370,8737790,420
FBgn0261268,Cul3,2L,15265245,15272024,6779
FBgn0261269,conv,2R,14270729,14275495,4766
FBgn0261270,Sps1,2R,14268772,14270658,1886
FBgn0261274,Ero1L,3L,4170404,4173789,3385
FBgn0261276,Opa1,2R,14230611,14235449,4838
FBgn0261277,rtv,X,11152484,11153990,1506
FBgn0261278,grp,2L,16680054,16699926,19872
FBgn0261279,lqfR,3R,22411301,22419051,7750
FBgn0261283,SREBP,3L,19793935,19798979,5044
FBgn0261284,bou,X,6986486,6987188,702
FBgn0261285,Ppcs,3R,19139054,19147910,8856
FBgn0261286,Mat89Ba,3R,16268329,16272415,4086
FBgn0261287,ymp,3R,25591502,25609127,17625
FBgn0261290,CheA84a,3R,8204195,8204830,635
FBgn0261292,CheB53a,2R,16466709,16467522,813
FBgn0261341,verm,3L,19690033,19695260,5227
FBgn0261349,Mst36Fb,2L,18673363,18675094,1731
FBgn0261353,Ccdc56,3L,11708979,11710570,1591
FBgn0261356,CG42633,3R,10780965,10782267,1302
FBgn0261360,CG42637,3L,19719527,19793569,74042
FBgn0261361,CG42638,3L,19745834,19749744,3910
FBgn0261363,PPO3,2R,23064769,23067183,2414
FBgn0261373,CG33228,2R,24668411,24669330,919
FBgn0261380,mRpL37,3R,10782563,10784092,1529
FBgn0261381,mtTFB1,3L,11708979,11710570,1591
FBgn0261385,scra,2R,7590119,7595242,5123
FBgn0261386,Gpa2,Unmapped_Scaffold_8_D1580_D1567,3093,3557,464
FBgn0261387,CG17528,2R,4815426,4824319,8893
FBgn0261393,alpha-Est5,3R,7533496,7536390,2894
FBgn0261394,Prosalpha3,2R,20994900,20996118,1218
FBgn0261395,Prosalpha3T,3R,31122527,31123415,888
FBgn0261396,Rpn3,2L,19051790,19053681,1891
FBgn0261397,didum,2R,7500147,7508625,8478
FBgn0261402,Ir75b,3L,17818073,17820193,2120
FBgn0261403,sxc,2R,5307288,5329555,22267
FBgn0261429,lncRNA:CR42646,2R,5363253,5367357,4104
FBgn0261434,hkb,3R,4345015,4346646,1631
FBgn0261436,DhpD,3R,4227387,4229238,1851
FBgn0261437,CSN8,2L,8364855,8365663,808
FBgn0261439,SdhA,2R,19391863,19395971,4108
FBgn0261444,CG3638,X,1215289,1236684,21395
FBgn0261445,sgl,3L,6959554,6964758,5204
FBgn0261446,CG13377,X,258335,263999,5664
FBgn0261454,scaRNA:MeU4-A65,3L,17628057,17628203,146
FBgn0261456,hpo,2R,19493996,19496856,2860
FBgn0261458,capt,2L,1151678,1158262,6584
FBgn0261461,RhoGAP18B,X,19136107,19167082,30975
FBgn0261477,slim,2R,18440965,18445526,4561
FBgn0261479,nero,3R,31746445,31747558,1113
FBgn0261503,lncRNA:CR42651,3R,6808796,6816379,7583
FBgn0261504,7SLRNA:CR42652,3R,6820131,6820429,298
FBgn0261505,CR42653,2R,1207416,1209312,1896
FBgn0261508,CG42656,3R,7492961,7493271,310
FBgn0261509,haf,2L,1555129,1609389,54260
FBgn0261514,NimA,2L,13957539,13963381,5842
FBgn0261522,lncRNA:CR42657,X,9688189,9689295,1106
FBgn0261524,lic,X,13091145,13093986,2841
FBgn0261526,NT1,3L,4501652,4508433,6781
FBgn0261529,ms(2)34Fe,2L,14328429,14333860,5431
FBgn0261530,nbs,3L,9720414,9723194,2780
FBgn0261532,cdm,3R,18179275,18183479,4204
FBgn0261534,l(2)34Fc,2L,14349020,14351513,2493
FBgn0261535,l(2)34Fd,2L,14352594,14355085,2491
FBgn0261538,CG42662,2R,15698726,15701696,2970
FBgn0261545,CG42663,2R,12705172,12751545,46373
FBgn0261547,Exn,3L,16970013,16994388,24375
FBgn0261549,rdgA,X,8907068,9029476,122408
FBgn0261550,Orp8,3R,20309344,20324196,14852
FBgn0261552,ps,3R,9417940,9455500,37560
FBgn0261553,CG42671,3L,11214505,11230745,16240
FBgn0261554,Arms,2R,21295652,21310411,14759
FBgn0261555,CG42673,3L,9547220,9596713,49493
FBgn0261556,CG42674,3L,20149614,20198317,48703
FBgn0261560,Thor,2L,3478434,3479612,1178
FBgn0261561,CG42675,3R,5813609,5818820,5211
FBgn0261562,CG42676,3L,1803107,1806920,3813
FBgn0261563,wb,2L,14263027,14328262,65235
FBgn0261564,ReepA,2R,22925107,22932044,6937
FBgn0261565,Lmpt,3L,16865295,16922487,57192
FBgn0261567,CG42681,2L,14744421,14744817,396
FBgn0261570,raskol,X,17710144,17752007,41863
FBgn0261573,CoRest,X,19521929,19530896,8967
FBgn0261574,kug,3L,20005301,20024607,19306
FBgn0261575,tobi,3R,25344761,25346921,2160
FBgn0261584,CG42694,2R,22941877,22945147,3270
FBgn0261587,CG42697,2R,18611645,18612730,1085
FBgn0261588,pdm3,2R,8327490,8396280,68790
FBgn0261592,RpS6,X,7899624,7901331,1707
FBgn0261596,RpS24,2R,22640526,22641419,893
FBgn0261597,RpS26,2L,18441335,18443277,1942
FBgn0261599,RpS29,3R,9778042,9779528,1486
FBgn0261602,RpL8,3L,2587456,2588883,1427
FBgn0261608,RpL37A,2L,5070957,5072055,1098
FBgn0261609,eIF2alpha,X,16445176,16446993,1817
FBgn0261610,CG42699,X,5764553,5789576,25023
FBgn0261611,CG42700,2R,12279771,12300795,21024
FBgn0261612,CngA,2R,16243145,16259805,16660
FBgn0261615,CG42704,X,7412668,7413296,628
FBgn0261617,nej,X,9665442,9687066,21624
FBgn0261618,larp,3R,28318162,28336440,18278
FBgn0261625,GLS,2R,12670483,12679593,9110
FBgn0261628,CG42711,2L,13930322,13931362,1040
FBgn0261632,lncRNA:CR42715,2R,14639361,14639762,401
FBgn0261634,CG42717,3L,16032762,16033190,428
FBgn0261636,lncRNA:CR42719,3L,615627,616646,1019
FBgn0261638,lncRNA:CR42721,3R,6767050,6779728,12678
FBgn0261639,CR42722,3L,24546138,24546986,848
FBgn0261640,CR42723,3L,24549636,24550445,809
FBgn0261641,CG42724,3R,6361672,6368288,6616
FBgn0261647,Axud1,2L,2365345,2370137,4792
FBgn0261648,salm,2L,11434311,11445614,11303
FBgn0261649,tinc,3R,17811541,17872507,60966
FBgn0261671,tweek,2L,16888490,16917052,28562
FBgn0261673,nemy,2R,12659497,12670219,10722
FBgn0261674,CG42709,3L,12790192,12796084,5892
FBgn0261675,Npc1b,X,20934869,20939503,4634
FBgn0261679,CG42726,3R,15348048,15350391,2343
FBgn0261680,CG42727,3R,15348048,15350391,2343
FBgn0261683,B9d2,2L,6127872,6130651,2779
FBgn0261686,CG42733,2R,10356171,10356800,629
FBgn0261697,tctn,2L,6127872,6130651,2779
FBgn0261698,SLO2,2R,10322195,10416996,94801
FBgn0261700,lncRNA:CR42736,2R,18377487,18378196,709
FBgn0261703,gce,X,15297766,15319074,21308
FBgn0261704,CG42740,3R,30418767,30422971,4204
FBgn0261705,CG42741,2R,23011078,23042943,31865
FBgn0261709,lncRNA:CR42746,2L,12543176,12544343,1167
FBgn0261710,nocte,X,10461865,10474675,12810
FBgn0261714,Cpn,3R,12162887,12166186,3299
FBgn0261722,fwe,3L,15810081,15816410,6329
FBgn0261723,Dbx,3L,1921307,1933602,12295
FBgn0261786,mi,2R,23523856,23528260,4404
FBgn0261787,brun,2L,20650755,20656178,5423
FBgn0261788,Ank2,3L,7655389,7718395,63006
FBgn0261789,SmD2,3R,6345000,6345911,911
FBgn0261790,SmE,2L,7884930,7885450,520
FBgn0261791,SNRPG,X,16639810,16640419,609
FBgn0261792,snRNP-U1-C,3R,18982964,18983650,686
FBgn0261793,Trf2,X,8409272,8433011,23739
FBgn0261794,kcc,2R,23907654,23925066,17412
FBgn0261797,Dhc64C,3L,4807368,4825687,18319
FBgn0261800,LanB1,2L,7811438,7820771,9333
FBgn0261801,CG42747,3L,6400590,6485964,85374
FBgn0261802,CG42748,2L,22131221,22166221,35000
FBgn0261803,CG42749,X,5296066,5306288,10222
FBgn0261804,CG42750,2L,18159811,18275770,115959
FBgn0261805,CG42751,2L,11853430,11853925,495
FBgn0261808,cu,3R,11197592,11208633,11041
FBgn0261811,pico,X,19830215,19852059,21844
FBgn0261822,Bsg,2L,8083420,8116531,33111
FBgn0261823,Asx,2R,14503958,14512493,8535
FBgn0261831,CG42763,2L,8144391,8145107,716
FBgn0261832,CG42764,3L,20464714,20466041,1327
FBgn0261833,lncRNA:CR42765,3R,26324499,26325294,795
FBgn0261834,CG42766,X,15976868,15977660,792
FBgn0261835,lncRNA:CR42767,X,9557539,9558466,927
FBgn0261836,Msp300,2L,5100877,5207002,106125
FBgn0261837,pre-mod(mdg4)-T,3R,21360176,21362131,1955
FBgn0261838,pre-mod(mdg4)-Z,3R,21360176,21362131,1955
FBgn0261839,pre-mod(mdg4)-Y,3R,21365609,21368279,2670
FBgn0261840,pre-mod(mdg4)-X,3R,21365609,21369330,3721
FBgn0261841,pre-mod(mdg4)-AD,3R,21365609,21368279,2670
FBgn0261842,pre-mod(mdg4)-AE,3R,21365609,21368279,2670
FBgn0261843,pre-mod(mdg4)-W,3R,21365609,21370249,4640
FBgn0261844,pre-mod(mdg4)-V,3R,21365609,21370249,4640
FBgn0261845,pre-mod(mdg4)-U,3R,21365609,21370249,4640
FBgn0261850,Xpd,2R,21171001,21174504,3503
FBgn0261854,aPKC,2R,14944458,14962969,18511
FBgn0261856,CR42785,2R,7000154,7001696,1542
FBgn0261857,CR42786,3R,20734748,20735323,575
FBgn0261858,Mzt1,3L,2389265,2389650,385
FBgn0261859,CG42788,3R,15095957,15131926,35969
FBgn0261862,whd,2R,10469473,10478567,9094
FBgn0261871,dpr2,2L,10917015,10964153,47138
FBgn0261872,scaf6,3L,17036859,17042574,5715
FBgn0261873,sdt,X,8178549,8240474,61925
FBgn0261881,Ankrd49,2L,15006583,15007431,848
FBgn0261885,osa,3R,17687818,17718350,30532
FBgn0261927,lncRNA:CR42794,X,5697123,5697660,537
FBgn0261928,CG42795,3R,10225690,10251277,25587
FBgn0261929,5-HT2B,3R,8578205,8629996,51791
FBgn0261930,vnd,X,582121,598151,16030
FBgn0261931,Hecw,X,9608946,9623243,14297
FBgn0261933,SmD1,3L,12733364,12734611,1247
FBgn0261934,dikar,3L,6728800,6743164,14364
FBgn0261938,PolrMT,2L,1103254,1108373,5119
FBgn0261952,srw,3L,4282956,4283478,522
FBgn0261953,TfAP-2,3L,21586828,21613349,26521
FBgn0261954,east,X,2010860,2024647,13787
FBgn0261955,Cs1,X,6350629,6361323,10694
FBgn0261963,mid,2L,5461639,5467610,5971
FBgn0261973,snoRNA:Or-CD9a,2R,24185825,24185922,97
FBgn0261974,snoRNA:Or-CD9b,2R,24186062,24186152,90
FBgn0261975,CG42806,2R,13964653,13965455,802
FBgn0261976,Psf2,2L,4386182,4387356,1174
FBgn0261983,l(2)gd1,2L,11106943,11110851,3908
FBgn0261984,Ire1,3R,19853908,19861291,7383
FBgn0261985,Ptpmeg,3L,328097,356050,27953
FBgn0261986,RASSF8,3R,25661795,25665640,3845
FBgn0261987,Pxt,3R,17719454,17722955,3501
FBgn0261988,Gprk2,3R,31405245,31457873,52628
FBgn0261989,CG42807,2R,13570595,13572759,2164
FBgn0261990,CG42808,2R,13573618,13574257,639
FBgn0261991,CG42809,2L,13457497,13458073,576
FBgn0261992,CG42810,2L,13459681,13460183,502
FBgn0261995,CG42813,3R,27227070,27228561,1491
FBgn0261998,CG42816,3L,17792088,17797594,5506
FBgn0261999,Ca-Ma2d,2L,16231475,16241527,10052
FBgn0262002,CG42820,2L,8389881,8392398,2517
FBgn0262003,CG42821,3R,17413077,17413639,562
FBgn0262004,CG42822,3R,17413901,17414607,706
FBgn0262005,CG42823,3R,17404487,17405109,622
FBgn0262009,CG42827,3R,23372924,23373600,676
FBgn0262018,CadN2,2L,17786971,17875247,88276
FBgn0262026,CG42837,2R,16197042,16199378,2336
FBgn0262029,dachs,2L,8466817,8488671,21854
FBgn0262035,CG42846,3L,230971,231604,633
FBgn0262036,CG42847,2L,9427870,9428740,870
FBgn0262057,Spn77Ba,3L,20317190,20320116,2926
FBgn0262081,Csk,3R,11633278,11650706,17428
FBgn0262097,lncRNA:CR42850,2L,5379095,5381074,1979
FBgn0262100,CG42853,3L,18120932,18121989,1057
FBgn0262101,CG42854,X,17245353,17247016,1663
FBgn0262102,CG42855,2R,18687372,18688641,1269
FBgn0262103,Sik3,2R,18688132,18705805,17673
FBgn0262106,lncRNA:CR42859,2L,2245230,2247383,2153
FBgn0262107,asRNA:CR42860,3L,2088166,2089626,1460
FBgn0262108,lncRNA:CR42861,X,13744928,13745476,548
FBgn0262109,lncRNA:CR42862,3L,224106,230964,6858
FBgn0262111,f,X,17232942,17280964,48022
FBgn0262112,sro,3R,29794597,29795805,1208
FBgn0262114,RanBPM,2R,10429708,10436581,6873
FBgn0262115,CG17683,2R,4130974,4133484,2510
FBgn0262116,RNASEK,2R,4186835,4188127,1292
FBgn0262117,IntS3,2R,4235779,4242934,7155
FBgn0262123,l(2)41Ab,2R,1349392,1443935,94543
FBgn0262124,uex,2R,3900285,3949425,49140
FBgn0262125,Sec23,3R,5649065,5652629,3564
FBgn0262126,Sec24CD,2L,2231106,2236844,5738
FBgn0262127,kibra,3R,14697689,14724261,26572
FBgn0262139,trh,3L,366524,392633,26109
FBgn0262141,CG42867,2R,22665646,22666145,499
FBgn0262142,lncRNA:CR42868,2R,22666359,22666764,405
FBgn0262146,MtnE,3R,20534021,20534704,683
FBgn0262148,lncRNA:CR42874,2L,1989450,1990894,1444
FBgn0262149,CR42875,3R,7128087,7129166,1079
FBgn0262160,CG9932,2L,13021868,13060140,38272
FBgn0262166,caly,2R,16194062,16196333,2271
FBgn0262167,ana1,3R,24530576,24536395,5819
FBgn0262169,magu,2R,10052541,10063712,11171
FBgn0262353,CG43051,2L,12507939,12508504,565
FBgn0262357,CG43055,2L,4411155,4411824,669
FBgn0262359,CG43057,2L,8243323,8244003,680
FBgn0262366,CG43064,3L,11834721,11836721,2000
FBgn0262467,Scox,2L,4967832,4968935,1103
FBgn0262473,Tl,3R,26799041,26842403,43362
FBgn0262475,bru2,2L,12344219,12397528,53309
FBgn0262476,CG43066,2R,18514574,18526439,11865
FBgn0262477,FoxP,3R,9726020,9730872,4852
FBgn0262478,CG43068,2R,15185158,15185952,794
FBgn0262481,CG43071,2R,18864621,18865218,597
FBgn0262482,CG43072,3L,21065852,21066238,386
FBgn0262483,Rbp,3R,15374635,15402543,27908
FBgn0262484,CG43074,3L,3483832,3484653,821
FBgn0262508,CG43078,3L,8576808,8599617,22809
FBgn0262509,nrm,3L,22998372,23040300,41928
FBgn0262510,CR43080,2L,454754,455313,559
FBgn0262512,Vha14-1,2R,15679426,15680084,658
FBgn0262515,VhaAC45,2R,9207561,9209774,2213
FBgn0262516,Trpml,3L,19714418,19718328,3910
FBgn0262517,Ltn1,3L,19544345,19552290,7945
FBgn0262518,Rab8,3L,19867488,19871078,3590
FBgn0262519,Mi-2,3L,19882051,19910215,28164
FBgn0262524,ver,3L,12523987,12525150,1163
FBgn0262527,nsl1,3R,15793782,15802102,8320
FBgn0262531,CG43085,3L,17645486,17646737,1251
FBgn0262532,CR43086,3L,17868740,17870573,1833
FBgn0262533,CR43087,3L,17874715,17876573,1858
FBgn0262537,CG43091,3R,22768121,22768733,612
FBgn0262538,CG43092,3R,22768883,22769667,784
FBgn0262539,CG43093,3R,22769775,22770307,532
FBgn0262540,CG43094,3R,22770613,22770987,374
FBgn0262541,CG43095,3R,22771156,22771770,614
FBgn0262559,Mdh2,3R,18226396,18228718,2322
FBgn0262560,wcd,2R,16345838,16347500,1662
FBgn0262562,CG43102,3R,17768272,17794490,26218
FBgn0262563,CG43103,2R,17139450,17139931,481
FBgn0262567,CG43107,2R,17140495,17140865,370
FBgn0262569,CG43109,2R,18867848,18868167,319
FBgn0262570,CG43110,2R,17477565,17486220,8655
FBgn0262574,CG43114,2R,11310831,11311165,334
FBgn0262577,CG43117,3R,26454794,26455112,318
FBgn0262579,Sarm,3L,8063874,8108897,45023
FBgn0262582,cic,3R,20252770,20303942,51172
FBgn0262587,CG43124,3R,28263871,28264773,902
FBgn0262593,Shab,3L,2895017,2959579,64562
FBgn0262598,mtsh,2L,8316889,8319908,3019
FBgn0262599,SmydA-3,2L,10850141,10854604,4463
FBgn0262601,SmB,2L,10425483,10426627,1144
FBgn0262604,lncRNA:CR43130,3R,8819618,8821098,1480
FBgn0262607,CG43133,X,18129585,18130178,593
FBgn0262614,pyd,3R,8827068,8931896,104828
FBgn0262617,Nuak,3R,10264306,10308467,44161
FBgn0262619,DNAlig1,2R,23890512,23893177,2665
FBgn0262620,lncRNA:CR43144,2L,21657625,21658249,624
FBgn0262622,lncRNA:CR43146,3L,13282393,13283410,1017
FBgn0262623,CG43147,3L,13299841,13300152,311
FBgn0262624,Tmhs,3L,1885657,1891462,5805
FBgn0262631,lncRNA:CR43148,2L,21624679,21626190,1511
FBgn0262636,dati,4,375640,395605,19965
FBgn0262647,Nup160,2L,11123777,11129335,5558
FBgn0262656,Myc,X,3373159,3391697,18538
FBgn0262679,CG43149,3L,53873,54751,878
FBgn0262682,asRNA:CR43152,X,12973825,12974615,790
FBgn0262685,CG43155,X,11459786,11476504,16718
FBgn0262686,CG43156,X,11906452,11906868,416
FBgn0262687,lncRNA:CR43157,X,11919125,11919657,532
FBgn0262689,asRNA:CR43159,3L,15520318,15521554,1236
FBgn0262699,fzr,X,4667290,4679537,12247
FBgn0262714,Sap130,3L,12805902,12813036,7134
FBgn0262716,Arp3,3L,8113407,8115902,2495
FBgn0262717,Skel,3R,10686943,10696270,9327
FBgn0262719,CG43163,3L,8472807,8507146,34339
FBgn0262721,CG43165,2L,3694431,3695020,589
FBgn0262728,Pal2,2R,23688077,23690838,2761
FBgn0262730,dtn,X,6225647,6236218,10571
FBgn0262731,CG33941,4,467497,471476,3979
FBgn0262732,mbf1,3L,16574436,16576871,2435
FBgn0262733,Src64B,3L,4592447,4626196,33749
FBgn0262734,eIF4H1,X,16448665,16454972,6307
FBgn0262736,Vha16-1,2R,6625242,6633090,7848
FBgn0262737,mub,3L,21844788,21932702,87914
FBgn0262738,norpA,X,4322626,4365408,42782
FBgn0262739,AGO1,2R,13943387,13958089,14702
FBgn0262740,Evi5,X,11430523,11454386,23863
FBgn0262741,lncRNA:CR43126,3R,28586048,28591386,5338
FBgn0262743,Fs(2)Ket,2L,20734609,20750941,16332
FBgn0262782,Mdh1,2L,10393774,10396332,2558
FBgn0262788,CG43169,3L,8888145,8888633,488
FBgn0262789,CR43170,3L,27170036,27170567,531
FBgn0262791,CG43172,2R,10351533,10352161,628
FBgn0262794,CG43175,3R,17630717,17645262,14545
FBgn0262801,twr,3R,6657882,6659442,1560
FBgn0262819,CG43190,2R,11844378,11845099,721
FBgn0262820,CG43191,2R,12035921,12037165,1244
FBgn0262823,hemo,3R,18564264,18565173,909
FBgn0262825,lncRNA:CR43196,3R,17382129,17382767,638
FBgn0262828,lncRNA:CR43199,X,7450383,7452199,1816
FBgn0262836,CG43200,2R,10351533,10352161,628
FBgn0262838,BomT1,2R,18381393,18381844,451
FBgn0262846,CG43210,3R,18564264,18565173,909
FBgn0262847,CR43211,X,11597748,11599638,1890
FBgn0262848,CR43212,X,11595655,11597545,1890
FBgn0262849,CR43213,X,11593562,11595452,1890
FBgn0262850,CR43214,X,11591469,11593359,1890
FBgn0262851,CR43215,X,11589376,11591266,1890
FBgn0262852,CR43216,X,11587283,11589173,1890
FBgn0262853,CR43217,X,11586228,11586944,716
FBgn0262854,CG43218,3L,21258020,21258758,738
FBgn0262855,CG43219,3L,21220400,21223118,2718
FBgn0262858,MtnF,3R,24634625,24635165,540
FBgn0262866,S6kII,X,22529964,22536371,6407
FBgn0262867,Ptr,2R,6181748,6196320,14572
FBgn0262869,Gfrl,3R,20378458,20484588,106130
FBgn0262870,axo,3L,4629604,4687317,57713
FBgn0262871,lute,3R,17379944,17390265,10321
FBgn0262872,milt,2L,7037823,7056010,18187
FBgn0262874,CG43229,X,18138542,18139000,458
FBgn0262877,CG43232,2L,6932121,6932954,833
FBgn0262881,Mtkl,2R,14638538,14638935,397
FBgn0262886,lncRNA:CR43241,2L,22131221,22132435,1214
FBgn0262887,lncRNA:CR43242,2L,23069005,23070724,1719
FBgn0262888,asRNA:CR43243,2R,21607687,21608477,790
FBgn0262889,CG43244,2R,12243999,12244701,702
FBgn0262890,CG43245,3L,10771925,10773399,1474
FBgn0262893,CG43248,3L,15530085,15531473,1388
FBgn0262898,lncRNA:CR43253,3L,18081121,18085310,4189
FBgn0262900,CG43255,X,8923960,8924449,489
FBgn0262901,lncRNA:CR43256,2R,5127249,5129296,2047
FBgn0262902,asRNA:CR43257,2R,24793807,24795772,1965
FBgn0262904,asRNA:CR43259,3R,25902846,25906766,3920
FBgn0262937,Rabex-5,3L,1295913,1298497,2584
FBgn0262945,lncRNA:CR43264,X,5831898,5832215,317
FBgn0262947,lncRNA:CR43266,2L,22840517,22843668,3151
FBgn0262948,CG43267,2R,7404035,7404441,406
FBgn0262952,mt:ND4,mitochondrion_genome,8207,9545,1338
FBgn0262954,Polr2K,2R,15144968,15145519,551
FBgn0262955,Polr2B,3R,14125791,14130111,4320
FBgn0262962,CG43273,3R,24830301,24830973,672
FBgn0262968,lncRNA:CR43279,X,7494544,7495497,953
FBgn0262970,CR43281,2R,4780311,4783646,3335
FBgn0262972,lncRNA:cherub,3R,11247631,11256123,8492
FBgn0262975,cnc,3R,23185580,23226711,41131
FBgn0262976,lawc,X,8408008,8411658,3650
FBgn0262979,lncRNA:CR43287,X,7707775,7708587,812
FBgn0262983,CG43291,3R,14234984,14244677,9693
FBgn0262985,CG43293,3L,6185189,6185853,664
FBgn0262987,CG43295,3L,16105852,16106428,576
FBgn0262992,lncRNA:CR43300,3R,13827968,13828427,459
FBgn0262993,lncRNA:CR43301,3R,9338223,9339992,1769
FBgn0263001,CR43309,3L,21829541,21830219,678
FBgn0263005,Chpf,X,13095571,13112462,16891
FBgn0263006,SERCA,2R,23925077,23935884,10807
FBgn0263019,lncRNA:CR43314,2L,11952200,11971094,18894
FBgn0263025,HSPBAP1,3R,27695235,27696531,1296
FBgn0263027,CG43322,2L,7013396,7014737,1341
FBgn0263029,CG43324,2R,17563606,17564351,745
FBgn0263030,CG43325,2R,22655549,22657135,1586
FBgn0263031,CG43326,2R,22655549,22656998,1449
FBgn0263032,CG43327,2R,17032487,17034012,1525
FBgn0263033,CG43328,2R,17032487,17034012,1525
FBgn0263036,CG43331,3L,22502978,22503830,852
FBgn0263042,lncRNA:CR43337,3L,620695,622316,1621
FBgn0263046,CG43341,2R,7632841,7633880,1039
FBgn0263047,CG43342,3R,22381340,22382147,807
FBgn0263048,Gpdh3,3R,22382035,22386548,4513
FBgn0263049,lncRNA:let7C,2L,18455717,18473132,17415
FBgn0263050,CG43345,2L,21166046,21168581,2535
FBgn0263051,CG43346,2L,21166046,21168581,2535
FBgn0263072,CG43347,X,10602641,10620190,17549
FBgn0263076,Klp54D,2R,17557031,17563406,6375
FBgn0263077,M7BP,2R,7623242,7651787,28545
FBgn0263079,CG43338,2L,18666892,18671246,4354
FBgn0263083,CG43351,2R,19030009,19030250,241
FBgn0263087,CG43355,2L,11484707,11486949,2242
FBgn0263088,lncRNA:CR43356,2L,12174090,12174638,548
FBgn0263093,CR43361,4,905179,907924,2745
FBgn0263095,lncRNA:CR43363,2L,19517992,19518632,640
FBgn0263096,CR43364,2L,3694105,3694418,313
FBgn0263102,psq,2R,10557888,10617280,59392
FBgn0263106,DnaJ-1,3L,5750029,5752189,2160
FBgn0263108,BtbVII,3L,3148646,3158408,9762
FBgn0263109,CG43366,2R,5893895,5931363,37468
FBgn0263110,CG43367,3L,4193993,4224003,30010
FBgn0263111,cac,X,11931280,11985087,53807
FBgn0263112,Mitf,4,1198852,1224467,25615
FBgn0263113,Cc2d2a,2R,17539322,17544353,5031
FBgn0263116,5-HT1B,2R,19022325,19032642,10317
FBgn0263117,CG34377,3R,22308663,22324094,15431
FBgn0263120,Acsl,2R,8665813,8683022,17209
FBgn0263121,Prosalpha1,2R,7827303,7828678,1375
FBgn0263131,CG43373,3L,16491838,16543370,51532
FBgn0263132,Cht6,X,10016845,10050803,33958
FBgn0263133,mEFG1,2L,7220369,7223081,2712
FBgn0263143,vret,3R,22742954,22745581,2627
FBgn0263144,bin3,2R,6214568,6240602,26034
FBgn0263197,Patronin,2R,17519024,17535866,16842
FBgn0263198,Acn,2L,19045355,19048817,3462
FBgn0263199,Galk,3L,8982212,8986091,3879
FBgn0263200,Galt,2L,6666264,6668033,1769
FBgn0263214,CR43384,X,19953659,19953882,223
FBgn0263216,CG43386,X,9966615,9977405,10790
FBgn0263219,Dscam4,3L,8238647,8282398,43751
FBgn0263220,Hk,X,10233347,10263485,30138
FBgn0263231,bel,3R,8654975,8660761,5786
FBgn0263232,Nxf3,3L,13965203,13973067,7864
FBgn0263233,robls54B,2R,17455743,17456441,698
FBgn0263236,SP1029,3R,29244961,29250451,5490
FBgn0263237,Cdk7,X,5307465,5308983,1518
FBgn0263239,dar1,3L,3626352,3653442,27090
FBgn0263240,Coop,2R,7490836,7492589,1753
FBgn0263241,Mocs1,3L,11070526,11073348,2822
FBgn0263251,vnc,3L,9972312,9974023,1711
FBgn0263256,CG43394,2L,8145758,8158786,13028
FBgn0263257,Cngl,X,15386038,15441252,55214
FBgn0263258,chas,X,17672458,17698730,26272
FBgn0263260,sel,2R,10050862,10052167,1305
FBgn0263271,CG43397,2R,10354724,10355831,1107
FBgn0263278,Fic,2L,6424336,6426371,2035
FBgn0263289,scrib,3R,26536350,26604051,67701
FBgn0263290,lncRNA:CR43399,2R,19144546,19145351,805
FBgn0263316,Mrp4,3R,11569250,11575937,6687
FBgn0263321,CG43402,2L,1442627,1443832,1205
FBgn0263323,lncRNA:CR43404,2L,9364297,9364991,694
FBgn0263330,lncRNA:CR43411,2L,14613258,14613621,363
FBgn0263332,asRNA:CR43413,2L,18200336,18201135,799
FBgn0263336,lncRNA:CR43417,2R,16817519,16819240,1721
FBgn0263342,lncRNA:CR43423,3L,637486,638568,1082
FBgn0263343,lncRNA:CR43424,3R,4984498,4986120,1622
FBgn0263344,asRNA:CR43425,4,867824,871426,3602
FBgn0263345,asRNA:CR43426,3L,22850111,22854434,4323
FBgn0263346,smash,3R,4659579,4712193,52614
FBgn0263351,AP-2mu,3R,22462455,22464603,2148
FBgn0263352,Unr,3L,8432322,8442381,10059
FBgn0263353,CG11000,3R,5802328,5813258,10930
FBgn0263354,CG42784,2L,13415431,13500427,84996
FBgn0263355,CG31688,2L,20426199,20447905,21706
FBgn0263376,CG43428,2R,14737578,14739242,1664
FBgn0263377,asRNA:CR43429,2R,15682569,15684933,2364
FBgn0263378,asRNA:CR43430,2R,19399769,19401335,1566
FBgn0263379,lncRNA:CR43431,3L,12648907,12653090,4183
FBgn0263380,lncRNA:marge,3L,14976626,14977631,1005
FBgn0263384,lncRNA:CR43436,3R,31767124,31767790,666
FBgn0263385,lncRNA:CR43437,4,426067,426601,534
FBgn0263390,Nha2,3R,22981459,22998528,17069
FBgn0263391,hts,2R,19397032,19424903,27871
FBgn0263392,Tet,3L,2786207,2879158,92951
FBgn0263395,hppy,2R,19178738,19227193,48455
FBgn0263396,sqd,3R,13634862,13646304,11442
FBgn0263397,Ih,2R,14276130,14300095,23965
FBgn0263398,Uck,3R,24290172,24293371,3199
FBgn0263400,CG43446,3R,20986504,20987936,1432
FBgn0263402,CG43448,3R,30237094,30237734,640
FBgn0263406,lncRNA:CR43452,3R,20678183,20679079,896
FBgn0263408,asRNA:CR43454,3R,22996454,22997785,1331
FBgn0263412,lncRNA:CR43458,3R,31132330,31133050,720
FBgn0263413,lncRNA:CR43459,3R,10093761,10101356,7595
FBgn0263415,lncRNA:CR43461,X,6732717,6735917,3200
FBgn0263441,asRNA:CR43464,2L,2000058,2003935,3877
FBgn0263442,asRNA:CR43465,2L,5969859,5971025,1166
FBgn0263443,asRNA:CR43466,2R,24881130,24881817,687
FBgn0263445,asRNA:CR43468,2R,12875164,12877280,2116
FBgn0263446,asRNA:CR43469,2R,12872756,12875087,2331
FBgn0263447,asRNA:CR43470,3L,7250640,7252598,1958
FBgn0263448,asRNA:CR43471,3R,15230836,15231503,667
FBgn0263449,asRNA:CR43472,3R,16168348,16169154,806
FBgn0263451,asRNA:CR43474,3R,22629575,22630671,1096
FBgn0263454,asRNA:CR43477,3R,12225324,12226249,925
FBgn0263455,asRNA:CR43478,3R,4982265,4983904,1639
FBgn0263456,nwk,3L,9137860,9145693,7833
FBgn0263457,asRNA:CR43480,X,23090324,23093609,3285
FBgn0263458,snoRNA:CG43051-a,2L,12508108,12508254,146
FBgn0263459,snoRNA:2R:9445410,2R,13557905,13558055,150
FBgn0263462,snoRNA:Dek-a,2R,16857413,16857578,165
FBgn0263463,snoRNA:gcl-a,2R,8724905,8725065,160
FBgn0263465,snoRNA:kis-a,2L,232166,232253,87
FBgn0263466,snoRNA:lola-a,2R,10536495,10536660,165
FBgn0263467,snoRNA:nop5-x16-a,2L,6917210,6917310,100
FBgn0263468,snoRNA:SC35-a,2L,12432798,12432950,152
FBgn0263469,snoRNA:SC35-b,2L,12433025,12433180,155
FBgn0263470,snoRNA:Tudor-SN-a,3L,259970,260280,310
FBgn0263472,snoRNA:2R:9445205,2R,13557700,13557850,150
FBgn0263474,scaRNA:PsiU2-38.40.42,2L,21177040,21177176,136
FBgn0263477,scaRNA:PsiU1-6,3R,9713607,9713765,158
FBgn0263484,snoRNA:Pi4KIIalpha-a,3R,5559878,5560038,160
FBgn0263485,scaRNA:PsiU2-55,2R,12161126,12161303,177
FBgn0263487,scaRNA:PsiU5-44,2R,14602986,14603124,138
FBgn0263488,sncRNA:CR43603,3L,5764861,5765046,185
FBgn0263490,mld,3R,24585653,24623899,38246
FBgn0263492,asRNA:CR43481,3L,9378160,9381119,2959
FBgn0263493,CR43482,3L,9386112,9386463,351
FBgn0263494,CR43483,3L,9385646,9386112,466
FBgn0263503,lncRNA:CR43492,X,18586223,18587219,996
FBgn0263504,lncRNA:CR43493,X,22487854,22490872,3018
FBgn0263507,lncRNA:CR43496,X,6758610,6759491,881
FBgn0034722,Rtf1,2R,22375090,22378484,3394
FBgn0025878,wrapper,2R,22379637,22382675,3038
FBgn0034723,CG13506,2R,22383134,22394015,10881
FBgn0034725,CG6044,2R,22404177,22408540,4363
FBgn0053200,VepD,2R,22408525,22409342,817
FBgn0034726,PolE4,2R,22411789,22412582,793
FBgn0022985,qkr58E-2,2R,22415560,22419001,3441
FBgn0034728,rad50,2R,22421013,22425482,4469
FBgn0034730,ppk12,2R,22427479,22429584,2105
FBgn0034731,CG10384,2R,22454741,22472995,18254
FBgn0034733,CG4752,2R,22478379,22483054,4675
FBgn0034734,CG4554,2R,22483303,22492033,8730
FBgn0034735,CG4610,2R,22492197,22494295,2098
FBgn0034736,gas,2R,22550094,22552113,2019
FBgn0034737,CG11362,2R,22562307,22563131,824
FBgn0003175,px,2R,22494297,22562065,67768
FBgn0034729,CG10344,2R,22425733,22426977,1244
FBgn0034727,mRpS29,2R,22418937,22420376,1439
FBgn0022986,qkr58E-1,2R,22412556,22415518,2962
FBgn0022984,qkr58E-3,2R,22409208,22411545,2337
FBgn0034724,babos,2R,22393876,22402059,8183
FBgn0034720,Liprin-gamma,2R,22333500,22373109,39609
FBgn0017482,T3dh,2R,22329726,22332072,2346
FBgn0034718,wdp,2R,22298214,22311937,13723
FBgn0034739,CG3927,2R,22594677,22596348,1671
FBgn0034741,CG4269,2R,22597245,22600695,3450
FBgn0034743,RpS16,2R,22605745,22607995,2250
FBgn0034744,Vps20,2R,22608310,22609419,1109
FBgn0053143,Idit,2R,22614328,22634084,19756
FBgn0026261,bonsai,2R,22637770,22638868,1098
FBgn0034740,nsr,2R,22650556,22653595,3039
FBgn0034758,CG13510,2R,22657901,22661389,3488
FBgn0034759,CG13511,2R,22657901,22661389,3488
FBgn0034761,CG4250,2R,22663692,22664474,782
FBgn0050273,CG30273,2R,22667155,22668848,1693
FBgn0050269,CG30269,2R,22667155,22668848,1693
FBgn0034763,RYBP,2R,22670587,22673212,2625
FBgn0050267,asRNA:CR30267,2R,22756165,22758995,2830
FBgn0011211,blw,2R,22799099,22802180,3081
FBgn0050271,CG30271,2R,22816474,22822111,5637
FBgn0050274,CG30274,2R,22825093,22828903,3810
FBgn0010078,RpL23,2R,22854383,22855694,1311
FBgn0004896,fd59A,2R,22868159,22870706,2547
FBgn0034788,CG13532,2R,22871190,22874427,3237
FBgn0034789,PIP5K59B,2R,22874769,22881436,6667
FBgn0034793,asrij,2R,22886398,22887578,1180
FBgn0034795,MED23,2R,22888928,22894425,5497
FBgn0034796,CG3700,2R,22894435,22895745,1310
FBgn0034792,YME1L,2R,22882747,22886247,3500
FBgn0034791,EMC8-9,2R,22881322,22882690,1368
FBgn0001263,inaD,2R,22855688,22858794,3106
FBgn0034786,CG13531,2R,22847832,22853827,5995
FBgn0000405,CycB,2R,22803521,22806948,3427
FBgn0005631,robo1,2R,22692524,22700970,8446
FBgn0020257,Ppa,2R,22684955,22688987,4032
FBgn0050196,CG30196,2R,22654805,22655392,587
FBgn0034756,Cyp6d2,2R,22652573,22654530,1957
FBgn0034755,CG3746,2R,22648995,22649750,755
FBgn0050195,CG30195,2R,22646616,22647245,629
FBgn0034753,CG2852,2R,22644646,22646344,1698
FBgn0040091,Ugt317A1,2R,22641786,22643917,2131
FBgn0034750,CG3732,2R,22638807,22640201,1394
FBgn0019949,Cdk9,2R,22636063,22637727,1664
FBgn0034748,Alkbh8,2R,22634019,22635942,1923
FBgn0034745,tous,2R,22609334,22613376,4042
FBgn0034742,CG4294,2R,22600405,22605667,5262
FBgn0034797,nahoda,2R,22896174,22916719,20545
FBgn0034803,CG9849,2R,22937279,22939025,1746
FBgn0021979,l(2)k09913,2R,23067196,23071875,4679
FBgn0034816,CG3085,2R,23074823,23076857,2034
FBgn0045483,Gr59a,2R,23080561,23081725,1164
FBgn0034827,Klp59D,2R,23141999,23144497,2498
FBgn0034826,CG13544,2R,23139080,23140577,1497
FBgn0034824,Klp59C,2R,23123923,23126042,2119
FBgn0034822,RpL37-2,2R,23100057,23100478,421
FBgn0034821,CG9876,2R,23090100,23094266,4166
FBgn0034817,Art7,2R,23076688,23079038,2350
FBgn0003062,Fib,2R,23072909,23074725,1816
FBgn0034814,CG9890,2R,23062747,23064260,1513
FBgn0010622,DCTN3-p24,2R,23061420,23062593,1173
FBgn0034808,CG9896,2R,22993669,22998884,5215
FBgn0034804,GrlHz,2R,22938987,22941169,2182
FBgn0034802,CNBP,2R,22934569,22937077,2508
FBgn0034800,CG3788,2R,22932035,22934077,2042
FBgn0010660,Nup214,2R,22918937,22924742,5805
FBgn0050187,CG30187,2R,22916843,22918790,1947
FBgn0034835,CG3092,2R,23232626,23233927,1301
FBgn0034844,CG9861,2R,23323659,23326745,3086
FBgn0050409,CR30409,2R,23354367,23355321,954
FBgn0050410,Rpi,2R,23355183,23356441,1258
FBgn0034853,Ice1,2R,23366866,23371459,4593
FBgn0041712,yellow-d,2R,23378573,23380438,1865
FBgn0034856,yellow-d2,2R,23381197,23382591,1394
FBgn0034858,eIF2Bdelta,2R,23386521,23389052,2531
FBgn0050411,CG30411,2R,23415939,23417238,1299
FBgn0034866,Or59c,2R,23472300,23473753,1453
FBgn0034861,CG9815,2R,23421521,23433354,11833
FBgn0034860,CG9812,2R,23412320,23419684,7364
FBgn0034859,CG3520,2R,23396770,23402309,5539
FBgn0028497,Mtmr6,2R,23389009,23396680,7671
FBgn0050414,CG30414,2R,23384200,23385468,1268
FBgn0040660,CG13551,2R,23377866,23383424,5558
FBgn0034854,Golgin245,2R,23371360,23377045,5685
FBgn0003977,vir,2R,23360192,23366355,6163
FBgn0034849,CG3500,2R,23356372,23357565,1193
FBgn0046253,CG3502,2R,23343405,23347641,4236
FBgn0050416,CG30416,2R,23321481,23323399,1918
FBgn0034840,CG3124,2R,23282743,23284113,1370
FBgn0034837,RpL22-like,2R,23246610,23247893,1283
FBgn0034834,LS2,2R,23210130,23211539,1409
FBgn0034870,CG13559,2R,23502946,23503815,869
FBgn0041234,Gr59f,2R,23542510,23543885,1375
FBgn0050185,AIMP3,2R,23544024,23544901,877
FBgn0034877,levy,2R,23548239,23548982,743
FBgn0010501,Dcp-1,2R,23551313,23553547,2234
FBgn0034880,ItgaPS5,2R,23556672,23560263,3591
FBgn0015277,Pi3K59F,2R,23560492,23564045,3553
FBgn0050184,CG30184,2R,23563973,23564780,807
FBgn0015903,apt,2R,23564891,23599526,34635
FBgn0004795,retn,2R,23632610,23654820,22210
FBgn0034887,St1,2R,23681623,23682952,1329
FBgn0016762,angel,2R,23694003,23695232,1229
FBgn0034893,mRpL43,2R,23698105,23699014,909
FBgn0013548,l(2)dtl,2R,23702477,23705403,2926
FBgn0034897,Sesn,2R,23713900,23734846,20946
FBgn0034902,CG5532,2R,23752754,23753515,761
FBgn0000562,egl,2R,23734904,23746829,11925
FBgn0011297,Alg3,2R,23705439,23709792,4353
FBgn0034894,sigmar,2R,23698949,23702406,3457
FBgn0050183,CG30183,2R,23690247,23697824,7577
FBgn0011296,l(2)efl,2R,23684651,23685543,892
FBgn0034885,Eglp4,2R,23607592,23614710,7118
FBgn0034883,Eglp2,2R,23603722,23616754,13032
FBgn0034879,Rrp4,2R,23555018,23556217,1199
FBgn0034878,pita,2R,23548967,23554712,5745
FBgn0034876,wmd,2R,23544823,23548151,3328
FBgn0050181,ppk3,2R,23538631,23540773,2142
FBgn0015372,RabX1,2R,23519839,23523613,3774
FBgn0034871,CG3906,2R,23511286,23512225,939
FBgn0034907,CG5539,2R,23804811,23806144,1333
FBgn0034908,CG5543,2R,23809236,23811398,2162
FBgn0034911,GlyT,2R,23820354,23839864,19510
FBgn0034914,CG5554,2R,23845001,23847024,2023
FBgn0024234,gbb,2R,23851562,23853247,1685
FBgn0034919,CG5569,2R,23865414,23866654,1240
FBgn0011236,ken,2R,23870273,23877442,7169
FBgn0034920,CG5597,2R,23886973,23888777,1804
FBgn0034928,CG13562,2R,23903750,23905269,1519
FBgn0034931,CG2812,2R,23925236,23926911,1675
FBgn0023477,Taldo,2R,23940410,23942114,1704
FBgn0001123,Galphas,2R,23942538,23946936,4398
FBgn0034936,Stoml2,2R,23949201,23952459,3258
FBgn0034937,fzr2,2R,23950647,23952096,1449
FBgn0034939,thoc5,2R,23954091,23956406,2315
FBgn0034943,Fmo-1,2R,23962956,23964641,1685
FBgn0020764,Alas,2R,23964772,23966757,1985
FBgn0003008,or,2R,23967939,23968943,1004
FBgn0034946,CG3065,2R,23970305,23972233,1928
FBgn0002791,mr,2R,23972431,23975408,2977
FBgn0005612,Sox14,2R,23978801,23985177,6376
FBgn0050178,CG30178,2R,23986615,23987308,693
FBgn0034950,Pask,2R,23988738,23992049,3311
FBgn0034957,Rsph4a,2R,24017421,24019896,2475
FBgn0034959,Xxylt,2R,24022343,24023981,1638
FBgn0011695,EbpIII,2R,24026172,24027518,1346
FBgn0034961,CG3163,2R,24029317,24030555,1238
FBgn0034962,MAN1,2R,24033974,24036707,2733
FBgn0034964,IntS1,2R,24037943,24044458,6515
FBgn0003353,sei,2R,24047411,24053035,5624
FBgn0034966,CG13563,2R,24055306,24057599,2293
FBgn0034968,RpL12,2R,24060378,24061860,1482
FBgn0034971,Gpat4,2R,24068757,24073552,4795
FBgn0034970,yki,2R,24065975,24068485,2510
FBgn0023170,RpL39,2R,24061853,24062431,578
FBgn0034965,ppk29,2R,24052917,24057137,4220
FBgn0028552,gammaSnap1,2R,24047145,24048903,1758
FBgn0011726,tsr,2R,24044453,24046805,2352
FBgn0034963,Not11,2R,24036720,24037915,1195
FBgn0013764,Chi,2R,24031538,24033943,2405
FBgn0050172,CG30172,2R,24030546,24031427,881
FBgn0061198,HSPC300,2R,24027717,24028789,1072
FBgn0034958,CG3907,2R,24019898,24022298,2400
FBgn0034956,CG4324,2R,24014917,24017198,2281
FBgn0034951,CG3860,2R,23992138,23995055,2917
FBgn0034948,PPP1R15,2R,23975599,23977255,1656
FBgn0034945,CG10904,2R,23968941,23970073,1132
FBgn0034942,CG13566,2R,23961477,23962577,1100
FBgn0034940,CG16787,2R,23956335,23957405,1070
FBgn0034938,CG3803,2R,23952513,23954048,1535
FBgn0034935,Orcokinin,2R,23946959,23949076,2117
FBgn0034933,CG3735,2R,23937077,23939754,2677
FBgn0015268,Nap1,2R,23905175,23907294,2119
FBgn0034925,CG5339,2R,23896896,23898246,1350
FBgn0034923,Upf3,2R,23893066,23894987,1921
FBgn0034921,DCP1,2R,23888764,23890276,1512
FBgn0025334,PHDP,2R,23883136,23884440,1304
FBgn0025336,CG4882,2R,23880817,23882927,2110
FBgn0025352,Mtpbeta,2R,23866648,23868603,1955
FBgn0025335,Cpes,2R,23862962,23865398,2436
FBgn0004581,bgcn,2R,23853270,23858921,5651
FBgn0034918,Pym,2R,23855954,23856936,982
FBgn0021895,ytr,2R,23847161,23851480,4319
FBgn0034915,eIF6,2R,23849246,23850301,1055
FBgn0034913,Snap29,2R,23843483,23844763,1280
FBgn0003401,shu,2R,23841461,23843286,1825
FBgn0034909,pippin,2R,23812185,23818327,6142
FBgn0028411,Nxt1,2R,23811321,23811974,653
FBgn0010278,Ssrp,2R,23806361,23809004,2643
FBgn0034974,CG16786,2R,24081782,24086287,4505
FBgn0034975,enok,2R,24099210,24107032,7822
FBgn0041706,CG3253,2R,24114398,24116359,1961
FBgn0021875,Zfrp8,2R,24133989,24135405,1416
FBgn0015544,spag,2R,24159384,24161503,2119
FBgn0034985,CG3328,2R,24162489,24173660,11171
FBgn0034988,cN-IIIB,2R,24195498,24197027,1529
FBgn0034989,CG3356,2R,24197824,24202187,4363
FBgn0050418,nord,2R,24243255,24255094,11839
FBgn0034996,CG13575,2R,24255327,24257414,2087
FBgn0005636,nvy,2R,24275734,24291084,15350
FBgn0034999,Fatp3,2R,24294097,24298111,4014
FBgn0004101,bs,2R,24342861,24376473,33612
FBgn0005638,slbo,2R,24331522,24334307,2785
FBgn0034998,CG13577,2R,24267377,24269179,1802
FBgn0034994,Ir60a,2R,24249055,24251303,2248
FBgn0050419,CG30419,2R,24212491,24229795,17304
FBgn0034986,mRpS17,2R,24173665,24174441,776
FBgn0041582,tamo,2R,24126638,24133551,6913
FBgn0023081,gek,2R,24092079,24098636,6557
FBgn0034972,CG10339,2R,24078234,24080527,2293
FBgn0002787,Rpn8,2R,24400028,24404527,4499
FBgn0035007,CG3492,2R,24472712,24474226,1514
FBgn0035008,CG3494,2R,24474299,24475261,962
FBgn0035010,CG13579,2R,24455292,24490656,35364
FBgn0029501,Crtp,2R,24494518,24497024,2506
FBgn0050169,Brca2,2R,24526172,24529581,3409
FBgn0035020,CG13585,2R,24531594,24533391,1797
FBgn0035022,CG11413,2R,24536190,24536791,601
FBgn0035023,ITP,2R,24537421,24558961,21540
FBgn0035024,CG11414,2R,24561607,24565058,3451
FBgn0035025,uri,2R,24565554,24568082,2528
FBgn0035027,CG3511,2R,24571627,24574503,2876
FBgn0020521,pio,2R,24581245,24597862,16617
FBgn0035031,CG13587,2R,24597995,24599091,1096
FBgn0035033,CG3548,2R,24599947,24602367,2420
FBgn0035034,CG3565,2R,24602472,24603488,1016
FBgn0035035,Samtor,2R,24603572,24604670,1098
FBgn0035039,Adck1,2R,24611703,24613906,2203
FBgn0015040,Cyp9c1,2R,24631063,24632923,1860
FBgn0035044,CG3663,2R,24661503,24662409,906
FBgn0035046,ND-19,2R,24664398,24665439,1041
FBgn0035047,Pof,2R,24669397,24671577,2180
FBgn0035049,Mmp1,2R,24671294,24688184,16890
FBgn0260456,CG4806,2R,24666158,24668343,2185
FBgn0050161,CG30161,2R,24663532,24664377,845
FBgn0050163,Cpr60D,2R,24662682,24663406,724
FBgn0035041,CG13594,2R,24615423,24638588,23165
FBgn0035040,CG4741,2R,24610801,24615158,4357
FBgn0035036,CG4707,2R,24604595,24607023,2428
FBgn0035032,ATPsynF,2R,24599088,24599821,733
FBgn0069913,CG4681,2R,24578247,24579827,1580
FBgn0035026,Fcp1,2R,24567987,24571821,3834
FBgn0016687,Nurf-38,2R,24558967,24561087,2120
FBgn0035016,CG4612,2R,24521874,24526089,4215
FBgn0017556,Prosalpha4T2,2R,24500780,24502277,1497
FBgn0015300,Ssl,2R,24499243,24500267,1024
FBgn0035006,CG4563,2R,24451084,24453040,1956
FBgn0010414,SerT,2R,24404595,24411074,6479
FBgn0000037,mAChR-A,2R,24378630,24390294,11664
FBgn0050421,Usp15-31,2R,24743749,24756976,13227
FBgn0035056,spz6,2R,24757378,24760466,3088
FBgn0035057,CG3880,2R,24760664,24762605,1941
FBgn0035059,CG3894,2R,24763167,24766750,3583
FBgn0035063,CG3594,2R,24780917,24781779,862
FBgn0035065,CG3589,2R,24783555,24785542,1987
FBgn0000157,Dll,2R,24814822,24835667,20845
FBgn0035077,CG9083,2R,24898273,24899505,1232
FBgn0022343,CG3760,2R,24938181,24939769,1588
FBgn0035085,CG3770,2R,24945139,24946636,1497
FBgn0035086,CG12851,2R,24948645,24955677,7032
FBgn0035088,CG3776,2R,24969678,24970855,1177
FBgn0035091,CG3829,2R,24986044,24990489,4445
FBgn0004055,uzip,2R,25012062,25031737,19675
FBgn0010435,emp,2R,24976456,24986070,9614
FBgn0035090,CG2736,2R,24973431,24975341,1910
FBgn0035089,Phk-3,2R,24970843,24973207,2364
FBgn0050424,cGlr2,2R,24965275,24967298,2023
FBgn0035087,CG2765,2R,24959841,24965076,5235
FBgn0027599,CG2790,2R,24946561,24948378,1817
FBgn0035084,CG15861,2R,24943392,24945201,1809
FBgn0035082,CG2811,2R,24939706,24940483,777
FBgn0043792,CG30427,2R,24928747,24937477,8730
FBgn0060296,pain,2R,24921505,24928275,6770
FBgn0035078,Tpc2,2R,24897902,24900734,2832
FBgn0035076,Ance-5,2R,24888628,24891023,2395
FBgn0035073,CG16896,2R,24871407,24874912,3505
FBgn0023181,Orc4,2R,24795740,24797414,1674
FBgn0028738,ETH,2R,24794670,24795482,812
FBgn0015801,Reg-5,2R,24788008,24793410,5402
FBgn0041205,key,2R,24785514,24787411,1897
FBgn0035064,TyrRS-m,2R,24781726,24783500,1774
FBgn0035060,Eps-15,2R,24768314,24775265,6951
FBgn0027590,GstE12,2R,24766718,24768172,1454
FBgn0040666,CG12848,2R,24762566,24763094,528
FBgn0035050,SiaT,2R,24691422,24694386,2964
FBgn0035092,Nplp1,2R,25032377,25040377,8000
FBgn0050430,CG30430,2R,25129432,25129985,553
FBgn0001325,Kr,2R,25226611,25231394,4783
FBgn0050428,CG30428,2R,25251927,25254535,2608
FBgn0035094,CG9380,2R,25183628,25255318,71690
FBgn0004181,Ebp,2R,25175126,25176715,1589
FBgn0011694,EbpII,2R,25173568,25174230,662
FBgn0004919,gol,2R,25072627,25084347,11720
FBgn0001147,gsb-n,2R,25040383,25052331,11948
FBgn0052475,mthl8,3L,22428,26308,3880
FBgn0002564,Lsp1gamma,3L,66430,68995,2565
FBgn0020386,Pdk1,3L,129450,145895,16445
FBgn0035099,CG6845,3L,146433,149056,2623
FBgn0035101,p130CAS,3L,152884,174517,21633
FBgn0035104,CG13875,3L,179923,182535,2612
FBgn0027786,Mtch,3L,184626,186310,1684
FBgn0035107,mri,3L,200174,202152,1978
FBgn0024945,NitFhit,3L,203730,205309,1579
FBgn0035109,CG13876,3L,206134,207527,1393
FBgn0035111,Dis3l2,3L,212709,216479,3770
FBgn0035112,CG13877,3L,218068,218663,595
FBgn0053229,CG33229,3L,223852,225605,1753
FBgn0052476,mthl14,3L,247491,250305,2814
FBgn0035120,wac,3L,258176,259097,921
FBgn0035122,mRpL17,3L,264779,265932,1153
FBgn0027111,miple1,3L,267299,270336,3037
FBgn0029002,miple2,3L,271200,275018,3818
FBgn0035124,ttm2,3L,275155,276667,1512
FBgn0004373,fwd,3L,305393,319884,14491
FBgn0035121,Tudor-SN,3L,259043,264380,5337
FBgn0024806,DIP2,3L,250229,257954,7725
FBgn0000541,E(bx),3L,233926,246912,12986
FBgn0035113,pyx,3L,217932,223069,5137
FBgn0035110,thoc7,3L,211636,212687,1051
FBgn0027587,Prp4k,3L,207184,211457,4273
FBgn0025592,Gk1,3L,202098,205844,3746
FBgn0035106,rno,3L,187207,199762,12555
FBgn0035103,Vdup1,3L,176306,178963,2657
FBgn0035102,CG7049,3L,175112,176228,1116
FBgn0040688,CG12483,3L,97628,98375,747
FBgn0035134,CG1231,3L,356422,357664,1242
FBgn0040291,Roc1b,3L,357981,358486,505
FBgn0035137,CG1233,3L,361472,365681,4209
FBgn0035140,BORCS6,3L,540851,542147,1296
FBgn0035142,Hipk,3L,543060,581099,38039
FBgn0035143,Ppm1,3L,581337,582810,1473
FBgn0035145,MED14,3L,593246,599239,5993
FBgn0035147,Gale,3L,648555,651311,2756
FBgn0035150,Rev1,3L,654363,657971,3608
FBgn0035149,MED30,3L,652987,654089,1102
FBgn0035148,CG3402,3L,651542,652881,1339
FBgn0016715,Reg-2,3L,605165,606569,1404
FBgn0035146,CG13893,3L,599094,604008,4914
FBgn0035144,Kah,3L,582824,589274,6450
FBgn0035141,Cypl,3L,542122,542931,809
FBgn0001316,klar,3L,434083,540614,106531
FBgn0035139,CG13891,3L,433146,433906,760
FBgn0023000,mth,3L,343378,346957,3579
FBgn0035132,mthl10,3L,332801,342915,10114
FBgn0035131,mthl9,3L,329822,332309,2487
FBgn0052343,Atac3,3L,324985,327992,3007
FBgn0052344,CG32344,3L,321233,324720,3487
FBgn0035155,RabX6,3L,690517,691951,1434
FBgn0035165,CG13887,3L,837861,839931,2070
FBgn0035167,Gr61a,3L,841451,843701,2250
FBgn0035168,Cep290,3L,843926,851080,7154
FBgn0035169,Dci,3L,851346,852673,1327
FBgn0035171,CG12502,3L,865396,871701,6305
FBgn0052479,Usp10,3L,871899,895313,23414
FBgn0028999,nerfin-1,3L,909112,912319,3207
FBgn0035173,CG13907,3L,877291,882013,4722
FBgn0035170,dpr20,3L,852720,857248,4528
FBgn0035166,JMJD5,3L,839980,841360,1380
FBgn0035164,CG13901,3L,836667,837821,1154
FBgn0035162,Sf3b3,3L,826720,833385,6665
FBgn0035161,CG13898,3L,803427,804051,624
FBgn0035160,hng3,3L,737680,755489,17809
FBgn0035159,CG13896,3L,710820,711850,1030
FBgn0025676,CkIIalpha-i3,3L,708601,710607,2006
FBgn0035158,CG13895,3L,705948,708205,2257
FBgn0035157,CG13894,3L,693083,699144,6061
FBgn0052483,CG32483,3L,688523,690081,1558
FBgn0035154,hiro,3L,685942,687958,2016
FBgn0035153,ebd1,3L,682885,685549,2664
FBgn0035152,CG3386,3L,680436,682470,2034
FBgn0035151,CG17129,3L,677879,680326,2447
FBgn0035179,aln,3L,993983,995703,1720
FBgn0035181,CG9205,3L,1034697,1036298,1601
FBgn0035186,CG13912,3L,1189588,1190472,884
FBgn0040281,Aplip1,3L,1196317,1199339,3022
FBgn0004430,LysS,3L,1227747,1228238,491
FBgn0004429,LysP,3L,1218082,1218696,614
FBgn0004427,LysD,3L,1210717,1211196,479
FBgn0035189,CG9119,3L,1203316,1204795,1479
FBgn0063667,meep,3L,1201871,1203036,1165
FBgn0035187,Trhn,3L,1190384,1193173,2789
FBgn0025525,bab2,3L,1140429,1177276,36847
FBgn0004870,bab1,3L,1036369,1101089,64720
FBgn0024277,trio,3L,995982,1034875,38893
FBgn0035192,galene,3L,1235726,1242025,6299
FBgn0035196,Bfc,3L,1250696,1251778,1082
FBgn0035199,tfc,3L,1256449,1274498,18049
FBgn0035203,Acat2,3L,1302944,1304717,1773
FBgn0035205,Ctr9,3L,1307224,1311805,4581
FBgn0035207,Herc4,3L,1313696,1318330,4634
FBgn0010246,Myo61F,3L,1318480,1329617,11137
FBgn0011361,ND-ACP,3L,1329949,1331631,1682
FBgn0010786,Hmbs,3L,1334889,1339415,4526
FBgn0029514,CG9166,3L,1351116,1352853,1737
FBgn0263510,nclb,2R,10875748,10877296,1548
FBgn0263511,Vsx1,X,5594255,5612865,18610
FBgn0263512,Vsx2,X,5528927,5560183,31256
FBgn0263584,asRNA:CR43609,2L,21952,24237,2285
FBgn0263586,lncRNA:CR43611,2R,6707306,6708960,1654
FBgn0263589,asRNA:CR43614,X,4368786,4373471,4685
FBgn0263593,Lpin,2R,8136986,8156654,19668
FBgn0263594,lost,3R,4403076,4407182,4106
FBgn0263598,Vha68-2,2L,12974322,12978607,4285
FBgn0263599,Brr2,3L,15960836,15967872,7036
FBgn0263600,PolD1,3L,15984322,15987815,3493
FBgn0263601,mib1,3L,16006552,16011812,5260
FBgn0263602,Tasp1,3L,16085221,16087525,2304
FBgn0263603,Zn72D,3L,16106594,16112626,6032
FBgn0263605,l(3)72Dn,3L,16226126,16228737,2611
FBgn0263606,Hsc20,3L,16233127,16234165,1038
FBgn0263607,l(3)72Dp,3L,16234140,16236999,2859
FBgn0263608,l(3)72Dr,3L,16237723,16239462,1739
FBgn0263619,asRNA:ASTR,3R,5607799,5609810,2011
FBgn0263620,asRNA:CR43629,3R,4452705,4454295,1590
FBgn0263621,CG43630,3R,12676010,12676260,250
FBgn0263626,lncRNA:CR43635,3R,5045207,5045948,741
FBgn0263628,asRNA:CR43637,X,2200623,2201857,1234
FBgn0263650,lncRNA:CR43641,3R,13815279,13815778,499
FBgn0263652,lncRNA:CR43643,3R,26018027,26019309,1282
FBgn0263655,CG43646,2R,7018760,7019390,630
FBgn0263656,CG43647,2R,7020133,7020746,613
FBgn0263659,lncRNA:CR43650,2R,16829095,16839494,10399
FBgn0263660,lncRNA:CR43651,2R,9552844,9553940,1096
FBgn0263662,lncRNA:Irar,3R,21592350,21594852,2502
FBgn0263663,lncRNA:CR43654,3R,22777567,22781465,3898
FBgn0263667,Lpt,2R,23898561,23903661,5100
FBgn0263697,Uba3,2R,13858952,13860432,1480
FBgn0263705,Myo10A,X,10930840,10964046,33206
FBgn0263706,CG43658,X,17456169,17561180,105011
FBgn0263738,Ada2a,3R,18252843,18255487,2644
FBgn0263740,eIF2gamma,3R,15257844,15263458,5614
FBgn0263745,CR43670,2L,16700940,16703197,2257
FBgn0263746,CR43671,2L,16728035,16729681,1646
FBgn0263747,CG43672,X,15772963,15778774,5811
FBgn0263748,CG43673,X,15779146,15780214,1068
FBgn0263750,CG43675,3R,9355495,9359189,3694
FBgn0263755,Su(var)3-9,3R,15259864,15263458,3594
FBgn0263757,Polr2D,3R,18252843,18255487,2644
FBgn0263762,CG43679,3L,15050856,15051425,569
FBgn0263766,asRNA:CR43683,2L,9961018,9962104,1086
FBgn0263768,lncRNA:CR43685,3R,7092347,7093707,1360
FBgn0263769,lncRNA:CR43686,X,18369811,18370118,307
FBgn0263772,CG43689,X,4075743,4092237,16494
FBgn0263773,fok,2L,20079270,20085070,5800
FBgn0263774,CG43691,2R,13389495,13393361,3866
FBgn0263776,CG43693,3L,11036358,11051371,15013
FBgn0263778,lncRNA:CR43695,X,8324491,8325189,698
FBgn0263780,CG17684,2R,1866080,2262115,396035
FBgn0263782,Hmgcr,3R,23733324,23750992,17668
FBgn0263829,CG34334,X,22872812,22875367,2555
FBgn0263830,CG40486,X,22958856,22960091,1235
FBgn0263831,Gen,3L,5149849,5152376,2527
FBgn0263832,Rcd5,3L,4040529,4042597,2068
FBgn0263834,CR43696,3R,22296870,22297544,674
FBgn0263835,CR43697,3R,22297548,22298051,503
FBgn0263838,lncRNA:CR43700,2L,19023671,19024440,769
FBgn0263843,lncRNA:CR43704,2L,3769926,3770454,528
FBgn0263846,CG43707,2L,3757256,3769525,12269
FBgn0263851,snoRNA:CD-24,4,65577,65645,68
FBgn0263852,Dad1,2L,8383612,8384137,525
FBgn0263855,BubR1,2R,5969099,5974385,5286
FBgn0263863,mRpL45,3R,22618492,22619826,1334
FBgn0263864,Dark,2R,17020027,17026703,6676
FBgn0263869,lncRNA:CR43716,2L,4582250,4582968,718
FBgn0263870,lncRNA:CR43717,2L,439539,440104,565
FBgn0263873,sick,2L,19796365,19958424,162059
FBgn0263911,COX8,3L,21538859,21539447,588
FBgn0263916,Ent2,2L,6562325,6564709,2384
FBgn0263929,jvl,3R,14741582,14795868,54286
FBgn0263930,dally,3L,8827505,8891192,63687
FBgn0263933,ebi,2L,415067,418536,3469
FBgn0263934,esn,2R,7086316,7127868,41552
FBgn0263967,asRNA:CR43723,2R,7492364,7493497,1133
FBgn0263968,nonC,X,6824496,6838122,13626
FBgn0263970,lncRNA:CR43724,2R,8028929,8029935,1006
FBgn0263973,jv,3L,6563197,6589479,26282
FBgn0263974,qin,3R,18591027,18650137,59110
FBgn0263975,CR43727,3L,16581637,16582767,1130
FBgn0263977,Tim17b,3R,3734855,3745306,10451
FBgn0263979,Caf1-55,3R,15225576,15227564,1988
FBgn0263980,Stacl,2R,15401096,15471884,70788
FBgn0263981,asRNA:CR43730,2R,16288927,16291474,2547
FBgn0263982,CG43731,2L,19102044,19102909,865
FBgn0263983,CG43732,3R,18950196,18976557,26361
FBgn0263986,cd,3R,22694959,22697990,3031
FBgn0263987,spoon,X,5412386,5420867,8481
FBgn0263988,Dic61B,3L,149679,152589,2910
FBgn0263993,CG43736,X,6863888,6881580,17692
FBgn0263994,CG43737,X,15175441,15189931,14490
FBgn0263995,cpo,3R,17919832,18018892,99060
FBgn0263996,CG43739,2L,20871335,20918931,47596
FBgn0263997,CG43740,X,10333652,10347794,14142
FBgn0263998,Ack-like,2R,13142834,13152677,9843
FBgn0264000,GluRIB,3L,9251978,9288522,36544
FBgn0264001,bru3,3L,13521907,13803400,281493
FBgn0264002,MsR2,3L,2282883,2300944,18061
FBgn0264005,Hmx,3R,17558930,17569097,10167
FBgn0264006,dysc,3L,13867414,13903236,35822
FBgn0264075,tgo,3R,9016773,9020022,3249
FBgn0264077,Cnx14D,X,16522967,16525415,2448
FBgn0264078,Flo2,X,14839376,14933946,94570
FBgn0264081,CG43750,2L,2389578,2390689,1111
FBgn0264084,lncRNA:CR43753,2L,2271319,2279714,8395
FBgn0264086,CG43755,2L,325522,329761,4239
FBgn0264087,Slob,2L,7642005,7675078,33073
FBgn0264089,sli,2R,15869495,15922118,52623
FBgn0264090,CG43759,X,18930335,19028629,98294
FBgn0264265,lncRNA:CR43765,2L,22239183,22239713,530
FBgn0264267,asRNA:CR43767,2L,1158576,1159355,779
FBgn0264270,Sxl,X,7074550,7098053,23503
FBgn0264272,mwh,3L,1200786,1232700,31914
FBgn0264273,Sema2b,2R,16386524,16431758,45234
FBgn0264291,Det,3R,17149667,17150455,788
FBgn0264294,Cyt-b5,2R,7533506,7535936,2430
FBgn0264301,CG43779,2L,13305920,13306755,835
FBgn0264302,wrm1,3L,7333544,7335226,1682
FBgn0264303,wrm2,3L,7333544,7335226,1682
FBgn0264305,CG43783,3L,8932235,8954272,22037
FBgn0264307,orb2,3L,8937100,8954463,17363
FBgn0264308,hbt,2L,13301814,13331121,29307
FBgn0264310,lncRNA:CR43785,3L,737052,737479,427
FBgn0264324,spg,3R,28845270,28870439,25169
FBgn0264325,Atg6,3R,24049180,24050782,1602
FBgn0264326,PolE1,3R,23348128,23355163,7035
FBgn0264327,asRNA:CR43786,2R,21656310,21657180,870
FBgn0264328,asRNA:CR43787,2R,24630901,24632932,2031
FBgn0264329,CG43788,2R,16937597,16938011,414
FBgn0264330,CG43789,2R,16938696,16938995,299
FBgn0264336,lncRNA:CR43792,2R,23476577,23477078,501
FBgn0264339,CG43795,2R,23444137,23491997,47860
FBgn0264343,CG43799,2L,7227734,7228641,907
FBgn0264344,CG43800,2L,7232165,7232813,648
FBgn0264345,lncRNA:CR43801,2L,6074251,6074796,545
FBgn0264350,asRNA:CR43806,2L,16178318,16179188,870
FBgn0264353,asRNA:CR43809,2L,21102586,21104298,1712
FBgn0264357,SNF4Agamma,3R,21140739,21214269,73530
FBgn0264360,asRNA:CR43812,2R,20264855,20265145,290
FBgn0264361,CG43813,2L,12343643,12344266,623
FBgn0264364,CG43816,2L,16004325,16005461,1136
FBgn0264368,asRNA:CR43820,2L,5062636,5063442,806
FBgn0264376,lncRNA:CR43828,2L,19919845,19921926,2081
FBgn0264381,asRNA:CR43833,X,13755322,13756013,691
FBgn0264383,lncRNA:CR43835,X,7500443,7501383,940
FBgn0264384,lncRNA:CR43836,X,8972908,9048991,76083
FBgn0264385,lncRNA:CR43837,X,6995882,6997799,1917
FBgn0264386,Ca-alpha1T,X,6104085,6192483,88398
FBgn0264389,opm,X,15064836,15066432,1596
FBgn0264390,lncRNA:CR43838,X,20759736,20760953,1217
FBgn0264393,CG43841,X,18439667,18440076,409
FBgn0264394,asRNA:CR43842,X,18460818,18462823,2005
FBgn0264395,CG43843,X,18459138,18460418,1280
FBgn0264426,CG43844,3R,21889539,21890171,632
FBgn0264427,CG43845,3R,5522299,5523120,821
FBgn0264432,CG43850,2L,13415431,13420645,5214
FBgn0264437,lncRNA:CR43855,2L,8590370,8594489,4119
FBgn0264438,lncRNA:CR43856,2L,15011815,15012667,852
FBgn0264439,lncRNA:CR43857,2L,7423820,7425932,2112
FBgn0264441,lncRNA:CR43859,2L,11205528,11206092,564
FBgn0264442,ab,2L,11210678,11261080,50402
FBgn0264443,CG43861,2L,19968684,20017282,48598
FBgn0264446,asRNA:CR43864,X,1902028,1903733,1705
FBgn0264447,asRNA:CR43865,2L,9372102,9374004,1902
FBgn0264448,asRNA:CR43866,2L,6004167,6006333,2166
FBgn0264449,CG43867,X,808217,927975,119758
FBgn0264460,asRNA:CR43868,3L,12498487,12500307,1820
FBgn0264462,lncRNA:CR43870,3L,17245882,17264290,18408
FBgn0264464,asRNA:CR43872,3L,20299410,20302295,2885
FBgn0264467,asRNA:CR43875,3L,20315134,20317283,2149
FBgn0264469,asRNA:CR43877,3L,21528546,21529115,569
FBgn0264475,lncRNA:CR43883,3L,820759,821512,753
FBgn0264477,asRNA:CR43885,3L,19543100,19543622,522
FBgn0264479,lncRNA:CR43887,3L,11693135,11693661,526
FBgn0264481,asRNA:CR43889,3L,19909365,19910203,838
FBgn0264482,lncRNA:CR43890,3L,20290702,20291152,450
FBgn0264489,CG43897,3L,9813847,9834345,20498
FBgn0264490,Eip93F,3R,21949114,22014539,65425
FBgn0264491,how,3R,22042191,22079321,37130
FBgn0264492,CkIIalpha,3L,23097072,23103460,6388
FBgn0264493,rdx,3R,13967061,14032057,64996
FBgn0264494,CG17646,2L,1732524,1750612,18088
FBgn0264495,gpp,3R,6406855,6449274,42419
FBgn0264496,asRNA:CR43898,2R,16221636,16223187,1551
FBgn0264500,lncRNA:CR43899,X,10210181,10210636,455
FBgn0264501,lncRNA:CR43900,2R,12259409,12260813,1404
FBgn0264502,CG43901,X,10905767,10923436,17669
FBgn0264503,CG43902,X,10158434,10195337,36903
FBgn0264504,asRNA:CR43903,3R,23694006,23694688,682
FBgn0264505,lncRNA:CR43904,2R,6158597,6159635,1038
FBgn0264507,asRNA:CR43906,X,258465,267253,8788
FBgn0264508,lncRNA:CR43907,2R,11616195,11616694,499
FBgn0264511,lncRNA:CR43910,3L,8569335,8569864,529
FBgn0264517,asRNA:CR43916,3L,3940519,3941301,782
FBgn0264539,lncRNA:CR43918,2R,13224175,13224462,287
FBgn0264541,CG43920,2R,17598845,17599253,408
FBgn0264542,hwt,X,12516634,12568452,51818
FBgn0264546,CG43925,2L,13176423,13176888,465
FBgn0264547,asRNA:CR43926,2L,5925205,5925961,756
FBgn0264548,lncRNA:CR43927,2L,22751304,22751795,491
FBgn0264549,lncRNA:CR43928,2L,3476343,3477648,1305
FBgn0264554,asRNA:CR43933,3L,21496393,21498830,2437
FBgn0264556,Gr39a,2L,21290734,21297686,6952
FBgn0264560,garz,2R,12326360,12333860,7500
FBgn0264561,Glg1,3L,21497549,21507538,9989
FBgn0264562,Hr4,X,1941940,2007956,66016
FBgn0264563,CG43935,3R,27065436,27065807,371
FBgn0264564,asRNA:CR43936,2L,11840455,11840913,458
FBgn0264565,lncRNA:CR43937,2L,11839298,11839660,362
FBgn0264567,lncRNA:CR43939,3L,21576033,21577219,1186
FBgn0264571,lncRNA:CR43943,3L,20439954,20440563,609
FBgn0264572,asRNA:CR43944,3L,20389853,20391387,1534
FBgn0264574,Glut1,3L,914074,993788,79714
FBgn0264598,PsGEF,X,2367121,2387664,20543
FBgn0264600,lncRNA:CR43949,3L,16020409,16021506,1097
FBgn0264602,lncRNA:CR43951,3L,16049235,16050303,1068
FBgn0264605,CG43954,3L,16676406,16711677,35271
FBgn0264606,Fife,3L,2655415,2711690,56275
FBgn0264607,CaMKII,4,1035288,1053703,18415
FBgn0264616,lncRNA:CR43956,4,132674,132874,200
FBgn0264617,asRNA:CR43957,4,56497,63124,6627
FBgn0264618,lncRNA:CR43958,4,557025,557854,829
FBgn0264672,Eogt,2L,2381097,2383073,1976
FBgn0264674,asRNA:CR43959,X,10256629,10261804,5175
FBgn0264678,lncRNA:CR43963,X,12717624,12730953,13329
FBgn0264679,asRNA:CR43964,2R,18775411,18777166,1755
FBgn0264691,Lst8,X,9604154,9605969,1815
FBgn0264693,ens,3L,4122907,4134550,11643
FBgn0264694,mgr,3R,11408792,11409875,1083
FBgn0264695,Mhc,2L,16766566,16788766,22200
FBgn0264699,CG43968,3L,23784231,23787405,3174
FBgn0264701,lncRNA:CR43970,3L,8915233,8915668,435
FBgn0264702,asRNA:CR43971,3L,15108001,15108935,934
FBgn0264703,CR43972,3L,15100054,15102040,1986
FBgn0264704,lncRNA:CR43973,3L,15098534,15099502,968
FBgn0264706,CR43975,3R,21216820,21217242,422
FBgn0264707,RhoGEF3,3L,277437,305292,27855
FBgn0264709,lncRNA:CR43978,3L,21684000,21684951,951
FBgn0264710,asRNA:CR43979,3L,21678002,21679713,1711
FBgn0264711,CG43980,3L,21644958,21666306,21348
FBgn0264712,CG1172,3R,5393922,5399510,5588
FBgn0264713,asRNA:CR43981,X,17857077,17858084,1007
FBgn0264721,lncRNA:CR43989,3L,11163849,11164801,952
FBgn0264723,lncRNA:CR43991,3L,12245510,12246048,538
FBgn0264727,lncRNA:CR43995,3L,22072369,22072620,251
FBgn0264740,CG43998,3R,23927728,23929000,1272
FBgn0264741,CG43999,3R,23927728,23929000,1272
FBgn0264742,CG44000,2L,5043270,5048365,5095
FBgn0264743,CG44001,2L,5043270,5048365,5095
FBgn0264744,CG44002,2L,3169820,3171092,1272
FBgn0264745,CR44003,2L,3171035,3172799,1764
FBgn0264746,CG44004,3L,18072362,18073863,1501
FBgn0264747,CG44005,3L,18070300,18072123,1823
FBgn0264748,CG44006,3L,18068728,18070150,1422
FBgn0264750,CG44008,2L,11841502,11842445,943
FBgn0264751,Vti1b,3R,18396995,18400339,3344
FBgn0264753,Rgk1,2R,19311148,19356525,45377
FBgn0264776,CG44014,3R,15507940,15508886,946
FBgn0264785,Hph,3R,5257037,5269507,12470
FBgn0264788,asRNA:CR44018,3R,10639279,10645773,6494
FBgn0264789,asRNA:CR44019,3R,5250913,5252132,1219
FBgn0264791,asRNA:CR44021,3R,24519625,24520078,453
FBgn0264793,lncRNA:CR44023,4,276523,278174,1651
FBgn0264794,lncRNA:CR44024,4,427331,431769,4438
FBgn0264815,Pde1c,2L,11814156,11928572,114416
FBgn0264816,koko,3R,18403026,18404726,1700
FBgn0264817,pre-lola-G,2R,10481894,10485252,3358
FBgn0264819,asRNA:CR44027,4,395396,395954,558
FBgn0264820,CR44028,4,637333,637787,454
FBgn0264821,asRNA:CR44029,4,879374,884752,5378
FBgn0264822,asRNA:CR44030,4,959675,962692,3017
FBgn0264823,asRNA:CR44031,4,1027863,1029359,1496
FBgn0264826,lncRNA:CR44034,3R,21615020,21615740,720
FBgn0264827,asRNA:CR44035,3R,9810020,9813929,3909
FBgn0264829,CG44037,3R,12258737,12262879,4142
FBgn0264830,CG44038,3R,12260969,12261230,261
FBgn0264831,lncRNA:CR44039,3R,12268784,12270223,1439
FBgn0264834,lncRNA:CR44042,2R,1348167,1349167,1000
FBgn0264835,lncRNA:CR44043,2R,1368921,1371468,2547
FBgn0264837,asRNA:CR44045,3R,30034540,30034907,367
FBgn0264838,asRNA:CR44046,3R,30049293,30052211,2918
FBgn0264839,asRNA:CR44047,3R,20827095,20828212,1117
FBgn0264841,asRNA:CR44049,3R,27260050,27261948,1898
FBgn0264844,asRNA:CR44052,3R,23706361,23707146,785
FBgn0264848,vih,3L,12504292,12505821,1529
FBgn0264855,AP-2alpha,2L,408030,414777,6747
FBgn0264862,asRNA:CR44053,X,16806047,16809230,3183
FBgn0264863,asRNA:CR44054,X,11139608,11141238,1630
FBgn0264869,lncRNA:CR44060,2L,850702,851163,461
FBgn0264871,asRNA:CR44062,3R,22550032,22552687,2655
FBgn0264872,asRNA:CR44063,2L,7369646,7370503,857
FBgn0264873,asRNA:CR44064,2L,1500830,1504204,3374
FBgn0264874,asRNA:CR44065,2L,2190191,2191272,1081
FBgn0264876,asRNA:CR44067,2R,24775711,24779987,4276
FBgn0264877,lncRNA:CR44068,2R,8157161,8158260,1099
FBgn0264878,asRNA:CR44069,2R,9610464,9615617,5153
FBgn0264879,lncRNA:CR44070,2R,9636996,9637673,677
FBgn0264892,asRNA:CR44083,2L,13284927,13286538,1611
FBgn0264894,CG44085,2L,13261008,13284043,23035
FBgn0264895,RapGAP1,2L,7497805,7578980,81175
FBgn0264900,lncRNA:CR44091,3R,31680596,31681019,423
FBgn0264901,lncRNA:CR44092,3R,24231186,24231719,533
FBgn0264902,asRNA:CR44093,3R,5659477,5660570,1093
FBgn0264904,asRNA:CR44095,3R,14568962,14569871,909
FBgn0264905,lncRNA:CR44096,3R,21720967,21723234,2267
FBgn0264906,lncRNA:CR44097,3R,24054391,24055092,701
FBgn0264907,CG44098,3R,4750409,4773197,22788
FBgn0264908,pHCl-1,3L,15848578,15899029,50451
FBgn0264909,lncRNA:CR44100,2R,4507995,4508445,450
FBgn0264912,lncRNA:CR44103,3R,5368481,5368806,325
FBgn0264915,asRNA:CR44106,3R,20911640,20912869,1229
FBgn0264916,asRNA:CR44107,3R,19149122,19149557,435
FBgn0264922,Sumo,2L,6966780,6967644,864
FBgn0264939,asRNA:CR44108,X,5914363,5914649,286
FBgn0264945,asRNA:CR44114,2L,2226753,2227604,851
FBgn0264946,asRNA:CR44115,2L,2236347,2237022,675
FBgn0264947,asRNA:CR44116,2L,8194509,8197049,2540
FBgn0264950,asRNA:CR44119,2L,8201557,8205298,3741
FBgn0264951,lncRNA:CR44120,2L,8205367,8205648,281
FBgn0264952,lncRNA:CR44121,2L,8205778,8206044,266
FBgn0264953,Piezo,2L,8163073,8190137,27064
FBgn0264954,fd3F,X,3802316,3811040,8724
FBgn0264955,asRNA:CR44124,X,17578689,17579135,446
FBgn0264958,lncRNA:CR44127,2R,5967397,5967746,349
FBgn0264959,Src42A,2R,5981844,6012795,30951
FBgn0264960,lncRNA:CR44129,X,16815495,16815945,450
FBgn0264962,Pcf11,2R,14860936,14871071,10135
FBgn0264975,Nrg,X,8517373,8555170,37797
FBgn0264978,Slh,2L,2488197,2492671,4474
FBgn0264979,CG4267,2L,2242378,2245274,2896
FBgn0264982,lncRNA:CR44133,3R,15986181,15993665,7484
FBgn0264983,asRNA:CR44134,3R,4436356,4437230,874
FBgn0264986,asRNA:CR44137,3R,11637177,11638553,1376
FBgn0264987,lncRNA:CR44138,3R,13376903,13377395,492
FBgn0264989,CG44140,2L,15694038,15694471,433
FBgn0264990,CG44141,2L,15659041,15659474,433
FBgn0264991,CG44142,3R,13312855,13313188,333
FBgn0264996,asRNA:CR44147,2L,3030412,3030903,491
FBgn0264998,lncRNA:CR44149,2L,9568155,9568785,630
FBgn0265001,ppk18,2L,9765357,9770996,5639
FBgn0265002,CG44153,2L,10064121,10180256,116135
FBgn0265003,koi,2R,6811019,6818199,7180
FBgn0265017,lncRNA:CR43751,2L,2181962,2185495,3533
FBgn0265040,lncRNA:CR44157,3R,4673977,4674610,633
FBgn0265041,CG44158,3R,18208779,18209282,503
FBgn0265042,Irk1,3R,23168317,23185642,17325
FBgn0265043,asRNA:CR44160,3R,17391502,17392173,671
FBgn0265044,lncRNA:CR44161,2R,6216197,6218619,2422
FBgn0265045,Strn-Mlck,2R,15946933,15989498,42565
FBgn0265046,CG44163,2R,22090795,22091395,600
FBgn0265047,FDY,Y,3022289,3024024,1735
FBgn0265048,cv-d,3R,15844466,15853581,9115
FBgn0265049,lncRNA:CR44164,2R,6681796,6682394,598
FBgn0265050,asRNA:CR44165,2R,6682521,6683749,1228
FBgn0265052,St3,2R,23683377,23687980,4603
FBgn0265053,asRNA:CR44168,2R,23358478,23358961,483
FBgn0265058,asRNA:CR44169,2R,6873149,6880088,6939
FBgn0265059,lncRNA:CR44170,2R,6979496,6980195,699
FBgn0265060,lncRNA:CR44171,2R,6980395,6981195,800
FBgn0265065,asRNA:CR44176,3R,14421751,14422549,798
FBgn0265066,lncRNA:CR44177,3R,14496378,14508987,12609
FBgn0265067,lncRNA:CR44178,3R,21088792,21095744,6952
FBgn0265068,asRNA:CR44179,3R,25491285,25493262,1977
FBgn0265070,asRNA:CR44181,2L,10695058,10698195,3137
FBgn0265071,asRNA:CR44182,2L,11280057,11280577,520
FBgn0265074,lncRNA:CR44185,2L,135402,136128,726
FBgn0265082,Cdep,3R,4910552,4945576,35024
FBgn0265083,CG44194,3R,12996876,12997726,850
FBgn0265084,CG44195,3L,7658409,7695654,37245
FBgn0265086,lncRNA:CR44197,2L,13089803,13090559,756
FBgn0265088,lncRNA:CR44199,2L,13146636,13146908,272
FBgn0265089,eIF4E3,3L,8229224,8230568,1344
FBgn0265096,asRNA:CR44201,2R,7394996,7396194,1198
FBgn0265101,Sgt1,3R,8304190,8305274,1084
FBgn0265102,Oseg1,3L,8407268,8412825,5557
FBgn0265103,asRNA:CR44205,2R,9766348,9767514,1166
FBgn0265104,lncRNA:CR44206,2R,13329352,13344808,15456
FBgn0265105,asRNA:CR44207,2R,9775110,9776370,1260
FBgn0265107,lncRNA:CR44209,2R,7533190,7533497,307
FBgn0265137,Spn42Da,2R,6875906,6878927,3021
FBgn0265139,Gr2a,X,1452430,1454177,1747
FBgn0265140,Meltrin,3R,14664907,14697292,32385
FBgn0265149,lncRNA:CR44218,2L,248909,249812,903
FBgn0265150,lncRNA:CR44219,2L,262203,263003,800
FBgn0265152,lncRNA:CR44221,2L,228037,228588,551
FBgn0265153,lncRNA:CR44222,2L,223519,224708,1189
FBgn0265155,asRNA:CR44224,2L,10506301,10507015,714
FBgn0265159,asRNA:CR44228,3R,8754064,8755916,1852
FBgn0265161,lncRNA:CR44230,3R,10682632,10684424,1792
FBgn0265174,PIG-V,2R,16955458,16957308,1850
FBgn0265176,lncRNA:CR44241,2R,15294595,15295088,493
FBgn0265177,CG44242,2R,16196384,16196928,544
FBgn0265178,Lipt1,2R,16197042,16199555,2513
FBgn0265180,CG44245,2R,21200483,21212969,12486
FBgn0265182,CG44247,2R,24876691,24881221,4530
FBgn0265184,CG44249,2R,22066883,22068372,1489
FBgn0265185,CG44250,2R,12950404,12952293,1889
FBgn0265187,Fatp2,2R,23055474,23061549,6075
FBgn0265189,sud1,3R,24915840,24917864,2024
FBgn0265190,PIG-S,3R,24913216,24917864,4648
FBgn0265191,Gyg,2R,21200483,21210821,10338
FBgn0265192,Snp,2R,22060950,22069757,8807
FBgn0265193,Atf-2,2R,24870108,24871509,1401
FBgn0265194,Trpm,2R,15262808,15309368,46560
FBgn0265197,CG44257,3R,17265278,17265821,543
FBgn0265201,CG44261,3R,9407694,9408169,475
FBgn0265205,lncRNA:CR44265,3R,21223623,21224589,966
FBgn0265252,asRNA:CR44266,X,11570455,11571358,903
FBgn0265253,asRNA:CR44267,3R,24912995,24913685,690
FBgn0265254,lncRNA:CR44268,2L,23173073,23173465,392
FBgn0265262,Vha68-1,2L,13000770,13004107,3337
FBgn0265263,CG42688,2L,19181965,19182810,845
FBgn0265264,CG17097,2L,10646415,10650152,3737
FBgn0265266,CG13639,3R,24859900,24860366,466
FBgn0265269,CG15425,2L,4257572,4258425,853
FBgn0265271,CG14717,3R,11696509,11698327,1818
FBgn0265272,CG30060,2R,13422978,13423647,669
FBgn0265274,Inx3,3R,28853606,28859497,5891
FBgn0265276,l(3)neo38,3R,11765038,11779128,14090
FBgn0265295,asRNA:CR42871,3L,14034531,14036836,2305
FBgn0265296,Dscam2,3L,7159199,7189931,30732
FBgn0265297,pAbp,2R,18140078,18147191,7113
FBgn0265298,SC35,2L,12431075,12434665,3590
FBgn0265299,lncRNA:CR44272,2R,7992196,7992567,371
FBgn0265301,lncRNA:CR44274,2R,8943495,8944295,800
FBgn0265308,lncRNA:CR44281,2R,8650697,8651496,799
FBgn0265310,lncRNA:CR44283,2R,9161484,9161998,514
FBgn0265313,CG44286,2R,9138486,9141981,3495
FBgn0265318,asRNA:CR44291,3R,8562828,8563798,970
FBgn0265338,lncRNA:CR44292,2R,9708696,9710496,1800
FBgn0265340,lncRNA:CR44294,2R,10026356,10026758,402
FBgn0265342,COX7CL,2R,10050348,10050874,526
FBgn0265343,asRNA:CR44297,2R,10052643,10052995,352
FBgn0265344,lncRNA:CR44298,2R,10053095,10053393,298
FBgn0265345,lncRNA:CR44299,2R,10782895,10785597,2702
FBgn0265346,lncRNA:CR44300,2R,10785714,10786026,312
FBgn0265347,lncRNA:CR44301,2R,10786195,10786493,298
FBgn0265348,lncRNA:CR44302,2R,10859695,10860191,496
FBgn0265351,nac,3R,8302686,8304023,1337
FBgn0265356,tn,2R,18987344,19008944,21600
FBgn0265362,CG44303,X,6686963,6687420,457
FBgn0265373,CG44314,2R,12052944,12056547,3603
FBgn0265376,lncRNA:CR44317,3R,4596283,4599749,3466
FBgn0265379,lncRNA:CR44320,3R,26195250,26230268,35018
FBgn0265380,asRNA:CR44321,3R,26260902,26261515,613
FBgn0265381,lncRNA:CR44322,3R,23372006,23372649,643
FBgn0265413,CG44325,X,9070318,9078499,8181
FBgn0265416,Neto,X,13445903,13527282,81379
FBgn0265419,lncRNA:CR44331,3R,8112699,8114003,1304
FBgn0265420,lncRNA:CR44332,3R,7626882,7627290,408
FBgn0265422,lncRNA:CR44334,3R,7312338,7312858,520
FBgn0265427,lncRNA:CR44339,2R,12985367,12985995,628
FBgn0265428,asRNA:CR44340,X,19495284,19495896,612
FBgn0265443,lncRNA:CR44343,2R,13254495,13255496,1001
FBgn0265447,lncRNA:CR44347,3L,10803997,10805934,1937
FBgn0265448,lncRNA:CR44348,3L,9741403,9744403,3000
FBgn0265451,asRNA:CR44351,3L,1773605,1775108,1503
FBgn0265453,lncRNA:CR44353,X,15547407,15547740,333
FBgn0265457,lncRNA:CR44357,X,7166451,7405797,239346
FBgn0265458,asRNA:CR44358,X,11079291,11079772,481
FBgn0265464,Traf6,X,8154599,8157386,2787
FBgn0265467,lncRNA:CR44360,3L,4377368,4377999,631
FBgn0265470,lncRNA:CR44363,3L,11405535,11406094,559
FBgn0265487,mbl,2R,17216549,17379376,162827
FBgn0265496,lncRNA:CR44365,2R,13574913,13577545,2632
FBgn0265497,lncRNA:CR44366,2R,13578036,13579626,1590
FBgn0265498,asRNA:CR44367,2R,13854659,13855894,1235
FBgn0265499,asRNA:CR44368,2R,14168844,14170917,2073
FBgn0265508,asRNA:CR44370,2R,15226938,15232665,5727
FBgn0265510,asRNA:CR44372,2R,15691054,15693887,2833
FBgn0265512,mlt,2R,10155916,10158931,3015
FBgn0265523,Smr,X,12684203,12742618,58415
FBgn0265524,asRNA:CR44374,X,21119529,21120176,647
FBgn0265525,asRNA:CR44375,2R,16581996,16583369,1373
FBgn0265530,lncRNA:CR44380,2R,16814395,16815495,1100
FBgn0265531,asRNA:CR44381,X,2065455,2066106,651
FBgn0265532,asRNA:CR44382,X,2071710,2072189,479
FBgn0265535,CG44385,X,11131340,11132412,1072
FBgn0265536,asRNA:CR44386,2R,17140579,17141194,615
FBgn0265540,asRNA:CR44390,2R,17023652,17026993,3341
FBgn0265541,CR44391,2R,17135595,17136325,730
FBgn0265542,lncRNA:CR44392,2L,16888507,16889530,1023
FBgn0265546,lncRNA:CR44396,2L,17245856,17246617,761
FBgn0265574,Cdc5,3L,357851,361383,3532
FBgn0265575,yin,X,3862966,3871939,8973
FBgn0265577,IBIN,2R,17671068,17671295,227
FBgn0265580,lncRNA:CR44407,2L,10710101,10710733,632
FBgn0265583,lncRNA:CR44410,2L,17589471,17589700,229
FBgn0265584,lncRNA:CR44411,2L,17588203,17588720,517
FBgn0265585,lncRNA:CR44412,2L,17606465,17607260,795
FBgn0265589,asRNA:CR44416,2R,17766865,17767145,280
FBgn0265590,lncRNA:CR44417,2R,17869027,17869857,830
FBgn0265595,CG44422,X,11219379,11302783,83404
FBgn0265596,lncRNA:CR44423,X,15636308,15637014,706
FBgn0265597,rsh,X,12988615,13079070,90455
FBgn0265598,Bx,X,18515428,18572809,57381
FBgn0265605,Ric,2R,16107440,16110017,2577
FBgn0265607,beat-IIIa,2L,17131024,17173118,42094
FBgn0265611,asRNA:CR44429,X,15297312,15298217,905
FBgn0265613,asRNA:CR44431,X,21043550,21044024,474
FBgn0265623,Su(z)2,2R,12996501,13007911,11410
FBgn0265625,CG44433,2R,18684230,18686775,2545
FBgn0265626,CG44434,2R,18678680,18684198,5518
FBgn0265627,CG44435,2R,18678680,18684198,5518
FBgn0265629,CG44437,X,13201170,13202262,1092
FBgn0265630,sno,X,13195499,13211674,16175
FBgn0265633,lncRNA:CR44440,4,44774,46074,1300
FBgn0265634,lncRNA:CR44441,4,194732,195900,1168
FBgn0265635,lncRNA:CR44442,2R,6820560,6822596,2036
FBgn0265637,lncRNA:CR44444,2R,7621887,7622695,808
FBgn0265638,lncRNA:CR44445,2R,8242396,8243500,1104
FBgn0265639,lncRNA:CR44446,2R,8245795,8246295,500
FBgn0265648,lncRNA:CR44455,2R,23127604,23128077,473
FBgn0265651,lncRNA:CR44458,2R,15371695,15372595,900
FBgn0265660,lncRNA:CR44467,2R,16849095,16849895,800
FBgn0265661,lncRNA:CR44468,2R,18805595,18807195,1600
FBgn0265662,lncRNA:CR44469,X,790284,790566,282
FBgn0265663,lncRNA:CR44470,X,2682829,2683845,1016
FBgn0265664,lncRNA:CR44471,X,5433439,5435797,2358
FBgn0265665,lncRNA:CR44472,2R,19504775,19505462,687
FBgn0265667,lncRNA:CR44474,2R,19604695,19605295,600
FBgn0265686,lncRNA:CR44493,2L,10943272,10943622,350
FBgn0265691,lncRNA:CR44498,X,6001511,6005713,4202
FBgn0265693,lncRNA:CR44500,X,7460409,7461088,679
FBgn0265699,lncRNA:CR44506,2R,19692214,19697195,4981
FBgn0265702,asRNA:CR44509,2R,19712095,19712849,754
FBgn0265705,asRNA:CR44512,X,19667018,19667746,728
FBgn0265707,lncRNA:CR44514,3L,705330,705723,393
FBgn0265710,lncRNA:CR44517,X,9140242,9141965,1723
FBgn0265714,CG44521,3L,5713331,5714029,698
FBgn0265717,lncRNA:CR44524,X,10893189,10893676,487
FBgn0265718,lncRNA:CR44525,3L,7408493,7409707,1214
FBgn0265719,lncRNA:CR44526,3L,8692703,8693191,488
FBgn0265726,Nna1,X,13692292,13717835,25543
FBgn0265737,lncRNA:CR44544,3L,10784590,10785360,770
FBgn0265757,lncRNA:CR44564,3L,17335921,17337097,1176
FBgn0265759,lncRNA:CR44566,3L,17631390,17632253,863
FBgn0265760,lncRNA:CR44567,3L,17633040,17633317,277
FBgn0265767,zyd,X,23022898,23035550,12652
FBgn0265778,PDZ-GEF,2L,6323767,6332789,9022
FBgn0265784,CrebB,X,18366357,18377864,11507
FBgn0265798,lncRNA:CR44587,2L,12024056,12025202,1146
FBgn0265800,lncRNA:CR44589,2L,12046442,12046679,237
FBgn0265806,lncRNA:CR44595,2L,12582402,12583550,1148
FBgn0265807,lncRNA:CR44596,2L,12581445,12582858,1413
FBgn0265808,lncRNA:CR44597,2L,12571160,12571606,446
FBgn0265809,lncRNA:CR44598,2L,12570672,12571157,485
FBgn0265810,asRNA:CR44599,2L,13384822,13385403,581
FBgn0265811,asRNA:CR44600,2L,13398858,13399831,973
FBgn0265814,lncRNA:CR44603,2L,1618637,1626021,7384
FBgn0265815,lncRNA:CR44604,2L,18002847,18003083,236
FBgn0265816,lncRNA:CR44605,2L,18003368,18003616,248
FBgn0265819,lncRNA:CR44608,2L,4228921,4229458,537
FBgn0265821,lncRNA:CR44610,2L,7174368,7174790,422
FBgn0265824,lncRNA:CR44613,2L,7177879,7178171,292
FBgn0265830,lncRNA:CR44619,X,12751867,12754571,2704
FBgn0265831,lncRNA:CR44620,X,13390235,13390560,325
FBgn0265836,CG44625,2R,20235545,20235945,400
FBgn0265839,lncRNA:CR44628,2R,20007095,20007645,550
FBgn0265845,lncRNA:CR44634,2R,20136959,20137162,203
FBgn0265846,lncRNA:CR44635,2R,20137398,20137616,218
FBgn0265847,lncRNA:CR44636,2R,20137894,20138245,351
FBgn0265855,lncRNA:CR44644,2R,20505895,20506395,500
FBgn0265856,lncRNA:CR44645,2R,20506195,20506895,700
FBgn0265857,lncRNA:CR44646,2R,20508495,20508795,300
FBgn0265858,lncRNA:CR44647,2R,20509395,20509695,300
FBgn0265859,lncRNA:CR44648,2R,20511095,20511595,500
FBgn0265862,lncRNA:CR44651,2R,20531867,20532969,1102
FBgn0265864,asRNA:CR44653,2R,20562245,20562695,450
FBgn0265872,lncRNA:CR44661,X,15079956,15080425,469
FBgn0265873,lncRNA:CR44662,X,15077498,15081255,3757
FBgn0265887,lncRNA:CR44676,3L,19560820,19561190,370
FBgn0265894,lncRNA:CR44683,3L,20626580,20628498,1918
FBgn0265901,asRNA:CR44690,X,2175817,2180816,4999
FBgn0265902,lncRNA:CR44691,X,17828096,17831094,2998
FBgn0265913,lncRNA:CR44702,3L,14885341,14886183,842
FBgn0265915,asRNA:CR44704,2R,21070749,21071895,1146
FBgn0265918,lncRNA:CR44707,X,18682143,18683303,1160
FBgn0265919,lncRNA:CR44708,X,18912352,18912752,400
FBgn0265920,lncRNA:CR44709,3L,4493734,4495215,1481
FBgn0265927,lncRNA:CR44716,3L,11250450,11250868,418
FBgn0265929,lncRNA:CR44718,3L,11236500,11237620,1120
FBgn0265931,lncRNA:CR44720,3L,11273960,11274562,602
FBgn0265935,coro,2R,6862001,6872718,10717
FBgn0265937,asRNA:CR44724,2R,21297495,21298495,1000
FBgn0265938,lncRNA:CR44725,2R,21531595,21532195,600
FBgn0265940,lncRNA:CR44727,2L,14234754,14235156,402
FBgn0265941,lncRNA:CR44728,2L,14235318,14236307,989
FBgn0265951,lncRNA:CR44738,2L,18906124,18906747,623
FBgn0265954,lncRNA:CR44741,2L,18954584,18954970,386
FBgn0265957,lncRNA:CR44744,2L,5258942,5259992,1050
FBgn0265959,rdgC,3L,20248080,20265554,17474
FBgn0265961,lncRNA:CR44748,2R,21663160,21663925,765
FBgn0265962,lncRNA:CR44749,2R,21708945,21709595,650
FBgn0265966,lncRNA:CR44753,X,391835,393227,1392
FBgn0265967,lncRNA:CR44754,X,16901767,16912724,10957
FBgn0265968,Tfb5,2L,5009931,5010834,903
FBgn0265974,ttv,2R,14526267,14587917,61650
FBgn0265977,lncRNA:CR44756,2R,22318995,22320895,1900
FBgn0265987,lncRNA:CR44766,X,10744508,10745250,742
FBgn0265991,Zasp52,2R,15762565,15817004,54439
FBgn0265993,lncRNA:CR44768,2L,18732464,18733323,859
FBgn0265997,lncRNA:CR44772,2L,2757940,2758176,236
FBgn0265998,Doa,3R,28888073,28922772,34699
FBgn0265999,lncRNA:CR44773,2L,6079764,6080128,364
FBgn0266000,CG44774,X,4926664,4938105,11441
FBgn0266002,lncRNA:CR44776,2L,6551854,6552436,582
FBgn0266005,lncRNA:CR44779,X,1047242,1088866,41624
FBgn0266011,lncRNA:CR44784,2R,23383483,23384177,694
FBgn0266019,rudhira,X,11816898,11837460,20562
FBgn0266020,lncRNA:CR44785,2L,21319600,21320320,720
FBgn0266028,asRNA:CR44793,2L,5525738,5526943,1205
FBgn0266041,asRNA:CR44806,2R,23908474,23908875,401
FBgn0266042,asRNA:CR44807,2R,23812185,23814771,2586
FBgn0266044,lncRNA:CR44809,2L,22169668,22170204,536
FBgn0266046,asRNA:bsAS,2R,24351477,24369689,18212
FBgn0266048,lncRNA:CR44813,2R,24390777,24391977,1200
FBgn0266049,lncRNA:CR44814,2R,24059477,24059913,436
FBgn0266051,lncRNA:CR44816,X,6370578,6371026,448
FBgn0266053,Patr-1,3R,17043564,17048421,4857
FBgn0266064,Glys,3R,15141843,15147531,5688
FBgn0266069,lncRNA:CR44822,2L,5631624,5632660,1036
FBgn0266072,lncRNA:CR44825,2L,7795849,7796260,411
FBgn0266073,lncRNA:CR44826,2R,24138629,24139127,498
FBgn0266083,ocm,2R,24186703,24195290,8587
FBgn0266084,Fhos,3L,8753619,8798719,45100
FBgn0266086,lncRNA:CR44828,2R,24738777,24739377,600
FBgn0266088,lncRNA:CR44830,2R,24955777,24957359,1582
FBgn0266094,lncRNA:CR44831,X,14952345,14953697,1352
FBgn0266095,lncRNA:CR44832,X,5790952,5791536,584
FBgn0266096,lncRNA:CR44833,X,4956646,5063868,107222
FBgn0266098,rg,X,5085759,5254864,169105
FBgn0266099,CG44836,3L,16390952,16400275,9323
FBgn0266100,CG44837,3L,11850645,11938872,88227
FBgn0266101,CG44838,3L,9461050,9475475,14425
FBgn0266102,CR44839,X,644226,644616,390
FBgn0266111,ana3,2R,12344983,12351325,6342
FBgn0266115,asRNA:CR44841,X,18804840,18806363,1523
FBgn0266117,asRNA:CR44843,3L,14560000,14560953,953
FBgn0266124,ghi,3L,9451876,9452790,914
FBgn0266129,lov,2R,25085780,25139627,53847
FBgn0266136,Gyc76C,3L,19750943,19793569,42626
FBgn0266137,Dop1R2,3R,29630304,29659984,29680
FBgn0266139,lncRNA:CR44845,2L,10208741,10209786,1045
FBgn0266141,asRNA:CR44847,2L,13784713,13785423,710
FBgn0266143,asRNA:CR44849,2L,14019395,14020325,930
FBgn0266144,asRNA:CR44850,2L,14349070,14349799,729
FBgn0266145,lncRNA:CR44851,2L,14355468,14356878,1410
FBgn0266148,lncRNA:CR44854,2L,14557939,14558852,913
FBgn0266149,lncRNA:CR44855,2L,14560778,14561355,577
FBgn0266161,lncRNA:CR44867,2L,15911691,15912062,371
FBgn0266162,lncRNA:CR44868,2L,15912558,15913109,551
FBgn0266166,asRNA:CR44872,2L,9959248,9960232,984
FBgn0266167,asRNA:CR44873,2L,10004310,10005043,733
FBgn0266168,lncRNA:CR44874,2L,10051362,10052289,927
FBgn0266170,pre-mod(mdg4)-C,3R,21362968,21365290,2322
FBgn0266171,pre-mod(mdg4)-AB,3R,21362968,21365290,2322
FBgn0266172,pre-mod(mdg4)-E,3R,21362968,21365488,2520
FBgn0266173,pre-mod(mdg4)-K,3R,21355692,21359768,4076
FBgn0266174,pre-mod(mdg4)-L,3R,21355692,21359768,4076
FBgn0266175,pre-mod(mdg4)-P,3R,21355692,21359768,4076
FBgn0266176,pre-mod(mdg4)-J,3R,21355692,21359768,4076
FBgn0266177,pre-mod(mdg4)-I,3R,21355692,21359768,4076
FBgn0266178,pre-mod(mdg4)-B,3R,21354445,21359768,5323
FBgn0266181,lncRNA:CRG,3R,21783540,21786208,2668
FBgn0266183,lncRNA:CR44889,X,19712934,19713821,887
FBgn0266186,Vamp7,2R,9841080,9842502,1422
FBgn0266195,Tgs1,3R,18255530,18257677,2147
FBgn0266196,asRNA:CR44891,X,496597,497374,777
FBgn0266197,asRNA:CR44892,X,498097,499456,1359
FBgn0266199,asRNA:CR44894,X,10114340,10208574,94234
FBgn0266201,asRNA:CR44896,X,2055948,2056425,477
FBgn0266202,asRNA:CR44897,2L,1381211,1382796,1585
FBgn0266203,lncRNA:CR44898,2L,1380083,1381326,1243
FBgn0266204,lncRNA:CR44899,2L,16293069,16293721,652
FBgn0266205,lncRNA:CR44900,2L,18185160,18185857,697
FBgn0266206,lncRNA:CR44901,2L,18261073,18262298,1225
FBgn0266209,lncRNA:CR44904,2L,18795824,18796180,356
FBgn0266210,lncRNA:CR44905,2L,19108785,19109883,1098
FBgn0266212,asRNA:CR44907,2L,20068793,20069318,525
FBgn0266215,asRNA:CR44910,2L,21163871,21164271,400
FBgn0266216,asRNA:CR44911,2L,21178410,21179729,1319
FBgn0266217,lncRNA:CR44912,2L,2427050,2427881,831
FBgn0266218,lncRNA:CR44913,2L,6619080,6619446,366
FBgn0266219,lncRNA:CR44914,2L,6872714,6874378,1664
FBgn0266220,lncRNA:CR44915,2L,6871335,6872536,1201
FBgn0266222,lncRNA:CR44917,2L,21855094,21869759,14665
FBgn0266227,lncRNA:CR44922,3R,4375084,4377600,2516
FBgn0266243,lncRNA:CR44938,3R,10385494,10387385,1891
FBgn0266251,lncRNA:CR44946,3R,18374536,18376497,1961
FBgn0266252,lncRNA:CR44947,3R,20892591,20893771,1180
FBgn0266254,lncRNA:CR44949,3R,25823706,25825211,1505
FBgn0266256,lncRNA:CR44951,3R,26607047,26608440,1393
FBgn0266258,lncRNA:CR44953,3R,29755190,29759040,3850
FBgn0266262,lncRNA:CR44957,X,4311989,4315059,3070
FBgn0266263,asRNA:CR44958,X,5680627,5682127,1500
FBgn0266264,asRNA:CR44959,X,6089878,6090648,770
FBgn0266268,FeCH,3R,31810460,31812296,1836
FBgn0266275,asRNA:CR44960,X,15082616,15083753,1137
FBgn0266276,asRNA:CR44961,X,15315056,15317967,2911
FBgn0266277,asRNA:CR44962,X,11790796,11791777,981
FBgn0266278,lncRNA:CR44963,X,14293465,14294044,579
FBgn0266279,lncRNA:CR44964,X,6746399,6748020,1621
FBgn0266280,lncRNA:CR44965,X,761976,762500,524
FBgn0266282,SMC6,3R,24189050,24193423,4373
FBgn0266284,Ns3,X,1461844,1464220,2376
FBgn0266303,asRNA:CR44968,2L,10297730,10298413,683
FBgn0266304,asRNA:CR44969,2L,122837,124031,1194
FBgn0266307,asRNA:CR44972,2L,13288302,13289021,719
FBgn0266308,lncRNA:CR44973,2L,13582569,13583033,464
FBgn0266309,lncRNA:CR44974,2L,15746257,15747000,743
FBgn0266310,asRNA:CR44975,2L,16697344,16697761,417
FBgn0266311,asRNA:CR44976,2L,1708452,1709244,792
FBgn0266312,lncRNA:CR44977,2L,19157868,19159299,1431
FBgn0266313,lncRNA:CR44978,2L,19600697,19605490,4793
FBgn0266315,lncRNA:CR44980,2L,20464502,20484702,20200
FBgn0266316,asRNA:CR44981,2L,20874114,20875540,1426
FBgn0266317,asRNA:CR44982,2L,2374955,2375582,627
FBgn0266319,asRNA:CR44984,2L,4074279,4075952,1673
FBgn0266320,lncRNA:CR44985,2L,5326504,5326832,328
FBgn0266321,lncRNA:CR44986,2L,5947647,5948397,750
FBgn0266322,asRNA:CR44987,2L,71039,73836,2797
FBgn0266324,asRNA:CR44989,2L,7220567,7221093,526
FBgn0266325,asRNA:CR44990,2L,7708100,7710456,2356
FBgn0266326,lncRNA:CR44991,2L,8403447,8403924,477
FBgn0266327,asRNA:CR44992,2L,8703475,8705450,1975
FBgn0266328,lncRNA:CR44993,2L,21628462,21628976,514
FBgn0266329,lncRNA:CR44994,2L,16490224,16490890,666
FBgn0266330,asRNA:CR44995,2L,10242685,10245977,3292
FBgn0266331,asRNA:CR44996,2L,7994798,7996494,1696
FBgn0266346,CngB,2R,21692691,21697152,4461
FBgn0266347,nAChRalpha4,3L,23206669,23287448,80779
FBgn0266348,lncRNA:CR44997,X,22657324,22797682,140358
FBgn0266349,asRNA:CR44998,X,15334478,15335971,1493
FBgn0266350,lncRNA:CR44999,X,3373159,3522787,149628
FBgn0266351,asRNA:CR45000,X,15926787,15927082,295
FBgn0266352,asRNA:CR45001,X,16632490,16632839,349
FBgn0266354,CG45002,X,16969069,17066732,97663
FBgn0266359,asRNA:CR45007,2L,9937232,9938833,1601
FBgn0266360,asRNA:CR45008,2L,7821034,7821343,309
FBgn0266361,asRNA:CR45009,X,23007672,23009452,1780
FBgn0266362,lncRNA:CR45010,X,23010972,23011293,321
FBgn0266365,lncRNA:CR45013,2L,11835320,11835903,583
FBgn0266366,lncRNA:CR45014,2L,11836440,11836808,368
FBgn0266369,Mtp,2L,20919094,20922876,3782
FBgn0266372,asRNA:CR45016,3R,10761148,10761797,649
FBgn0266376,lncRNA:CR45018,X,13304005,13308004,3999
FBgn0266377,Pde8,2R,23657567,23680844,23277
FBgn0266379,lncRNA:CR45021,2R,15987446,15988086,640
FBgn0266382,asRNA:CR45024,3R,20677080,20677858,778
FBgn0266384,asRNA:CR45026,3L,5780102,5780863,761
FBgn0266388,asRNA:CR45028,3R,18668572,18669482,910
FBgn0266390,lncRNA:CR45030,3R,29095368,29096487,1119
FBgn0266393,CR45033,3R,5269081,5269507,426
FBgn0266396,lncRNA:CR45036,3L,11364683,11365897,1214
FBgn0266399,lncRNA:CR45039,3R,26006502,26007073,571
FBgn0266401,asRNA:CR45041,3R,28237449,28238570,1121
FBgn0266404,asRNA:CR45044,3R,29031028,29034098,3070
FBgn0266405,CG45045,3R,17667572,17667825,253
FBgn0266406,asRNA:CR45046,3R,21878672,21884101,5429
FBgn0266407,lncRNA:CR45047,3R,19907681,19908091,410
FBgn0266408,lncRNA:CR45048,3R,19908403,19910318,1915
FBgn0266409,CG45049,3R,22726967,22732362,5395
FBgn0266410,drn,3R,9340216,9362994,22778
FBgn0266411,sima,3R,30058311,30121798,63487
FBgn0266413,asRNA:CR45053,3R,9632035,9633076,1041
FBgn0266414,lncRNA:CR45054,3R,10083381,10090525,7144
FBgn0266416,asRNA:CR45056,3R,11535495,11536273,778
FBgn0266417,ringer,3L,16354746,16359428,4682
FBgn0266418,wake,3R,22639808,22683827,44019
FBgn0266420,Ote,2R,18275607,18277177,1570
FBgn0266428,asRNA:CR43463,2L,14359285,14361303,2018
FBgn0266429,AstA-R1,X,3574536,3666724,92188
FBgn0266431,CG45061,X,9871098,9871702,604
FBgn0266432,CG45062,2R,22472995,22476314,3319
FBgn0266433,CG45063,2R,22476385,22477295,910
FBgn0266434,CG45064,X,14875370,14882586,7216
FBgn0266435,CG45065,X,14875370,14882586,7216
FBgn0266437,CG45067,3L,3111233,3114467,3234
FBgn0266438,PIG-Z,2R,24411870,24415295,3425
FBgn0266439,CG45069,2R,24411870,24415295,3425
FBgn0266441,CG45071,3L,15105882,15110730,4848
FBgn0266445,CG45075,2L,6091412,6096498,5086
FBgn0266446,CG45076,3R,10768001,10777374,9373
FBgn0266448,CG45078,3R,10773339,10777374,4035
FBgn0266449,Kr-h2,2L,6070990,6073961,2971
FBgn0266450,Kr-h1,2L,6082603,6096498,13895
FBgn0266451,fau,3R,10773197,10777374,4177
FBgn0266452,Ctps,3L,15097914,15113003,15089
FBgn0266455,CG45080,3R,13318991,13319270,279
FBgn0266456,CG45081,3L,19266061,19266838,777
FBgn0266457,lncRNA:CR45082,X,21496526,21520017,23491
FBgn0266464,Nsf2,3R,13833497,13837991,4494
FBgn0266465,GckIII,3R,17085513,17087988,2475
FBgn0266486,CG45085,2R,9186670,9192096,5426
FBgn0266487,CG45086,2R,12612740,12619820,7080
FBgn0266488,CG45087,2R,18536767,18539416,2649
FBgn0266489,CG45088,2R,13580586,13593339,12753
FBgn0266490,CG45089,X,7893053,7893798,745
FBgn0266491,SclA,2L,16837972,16841884,3912
FBgn0266492,SclB,2L,16837972,16841884,3912
FBgn0266518,Dpit47,2R,6660645,6662118,1473
FBgn0266521,stai,2L,6100377,6124653,24276
FBgn0266525,CG45092,2R,6699695,6715892,16197
FBgn0266534,CG45095,3R,25102553,25103617,1064
FBgn0266538,CG45099,3R,22032150,22034286,2136
FBgn0266539,CG45100,3R,5472810,5474600,1790
FBgn0266540,CG45101,3L,11064991,11069025,4034
FBgn0266549,lncRNA:CR45102,X,3701857,3703285,1428
FBgn0266557,kis,2L,210735,250823,40088
FBgn0266566,CG45105,3R,15910372,15918007,7635
FBgn0266569,CG42259,X,1046224,1047009,785
FBgn0266570,NO66,X,4319438,4321745,2307
FBgn0266572,ebo,X,471019,476579,5560
FBgn0266577,asRNA:CR45108,2R,7783334,7785585,2251
FBgn0266578,lncRNA:CR45109,3R,13132429,13155687,23258
FBgn0266579,tau,3R,27639886,27656996,17110
FBgn0266580,Gp210,2R,5760862,5774324,13462
FBgn0266581,pit,3R,22034298,22038925,4627
FBgn0266582,ND-30,3L,3158485,3159578,1093
FBgn0266590,lncRNA:CR45115,3L,6865449,6866439,990
FBgn0266594,lncRNA:CR45119,3L,11050408,11050908,500
FBgn0266596,asRNA:CR45121,3L,9695043,9695650,607
FBgn0266598,Kmn2,3R,8000548,8001309,761
FBgn0266599,Hsc70-4,3R,15242687,15246614,3927
FBgn0266616,lncRNA:CR45123,4,851174,851624,450
FBgn0266617,asRNA:CR45124,4,42774,43374,600
FBgn0266618,lncRNA:CR45125,4,380724,381275,551
FBgn0266619,asRNA:CR45126,4,459768,461413,1645
FBgn0266621,lncRNA:CR45128,2R,6663395,6664195,800
FBgn0266622,asRNA:CR45129,2R,7325896,7335195,9299
FBgn0266623,asRNA:CR45130,2R,7578665,7579929,1264
FBgn0266624,asRNA:CR45131,2R,7631495,7635219,3724
FBgn0266625,asRNA:CR45132,2R,9284845,9285594,749
FBgn0266626,asRNA:CR45133,2R,10152717,10154345,1628
FBgn0266627,asRNA:CR45134,2R,10478043,10478795,752
FBgn0266628,asRNA:CR45135,2R,10541595,10541995,400
FBgn0266629,asRNA:CR45136,2R,10853546,10854495,949
FBgn0266630,asRNA:CR45137,2R,12783611,12799259,15648
FBgn0266632,asRNA:CR45139,2R,3943429,3949757,6328
FBgn0266633,asRNA:CR45140,2R,12867609,12869783,2174
FBgn0266634,asRNA:CR45141,2R,12881445,12883253,1808
FBgn0266635,asRNA:CR45142,2R,13168500,13170745,2245
FBgn0266636,asRNA:CR45143,2R,15676441,15676845,404
FBgn0266637,asRNA:CR45144,2R,17036695,17037982,1287
FBgn0266638,asRNA:CR45145,2R,17040195,17043298,3103
FBgn0266639,asRNA:CR45146,2R,17697532,17698796,1264
FBgn0266642,asRNA:CR45149,2R,21309395,21310146,751
FBgn0266644,asRNA:CR45151,2R,22174951,22176707,1756
FBgn0266645,asRNA:CR45152,2R,22415795,22416462,667
FBgn0266647,CG45154,X,21146281,21147041,760
FBgn0266649,lncRNA:CR45156,3L,4345801,4347801,2000
FBgn0266651,lncRNA:CR45158,3L,11632705,11633303,598
FBgn0266653,asRNA:CR45160,3L,5135542,5136224,682
FBgn0266654,asRNA:CR45161,3L,19989706,19990739,1033
FBgn0266655,asRNA:CR45162,3L,21268601,21269142,541
FBgn0266656,asRNA:CR45163,3L,22738708,22739434,726
FBgn0266657,asRNA:CR45164,3L,23149530,23150668,1138
FBgn0266666,Sem1,2L,7063986,7064467,481
FBgn0266667,Exo70,3L,8411851,8415910,4059
FBgn0266668,Exo84,3R,26049731,26052257,2526
FBgn0266669,Sec3,3L,17421787,17425217,3430
FBgn0266670,Sec5,2L,3457302,3460367,3065
FBgn0266671,Sec6,2R,18625249,18627718,2469
FBgn0266672,Sec8,3R,5754932,5758997,4065
FBgn0266673,Sec10,3R,24134831,24137538,2707
FBgn0266674,Sec15,3R,21105046,21107972,2926
FBgn0266676,lncRNA:CR45166,3L,1322877,1324221,1344
FBgn0266677,asRNA:CR45167,3L,5918389,5919556,1167
FBgn0266679,lncRNA:CR45169,3L,10850070,10850690,620
FBgn0266680,lncRNA:CR45170,3L,2517161,2518402,1241
FBgn0266681,asRNA:CR45171,3L,10893646,10894743,1097
FBgn0266685,asRNA:CR45175,3L,17841671,17842599,928
FBgn0266686,lncRNA:CR45176,3L,20439600,20439921,321
FBgn0266687,lncRNA:CR45177,3L,27091705,27092199,494
FBgn0266690,lncRNA:CR45180,3L,25708177,25709251,1074
FBgn0266691,lncRNA:CR45181,3L,27135424,27136049,625
FBgn0266692,asRNA:CR45182,3L,25843821,25844502,681
FBgn0266694,lncRNA:CR45184,3L,826720,830190,3470
FBgn0266696,Svil,3L,2377655,2499226,121571
FBgn0266697,lncRNA:CR45187,3R,4402429,4402928,499
FBgn0266700,asRNA:CR45190,3R,31588279,31590411,2132
FBgn0266702,asRNA:CR45192,3R,5835478,5836178,700
FBgn0266705,asRNA:CR45195,3R,10876834,10877783,949
FBgn0266707,lncRNA:CR45197,X,2675188,2676657,1469
FBgn0266709,Zmynd10,3L,13024763,13026437,1674
FBgn0266710,hog,X,14718273,14718942,669
FBgn0266711,EloC,2R,19445085,19446286,1201
FBgn0266717,Bruce,3R,10312039,10331353,19314
FBgn0266719,stac,3R,25056286,25064348,8062
FBgn0266720,Snap24,3R,9761305,9763150,1845
FBgn0266721,gammaSnap2,3R,10120399,10121400,1001
FBgn0266722,Trs33,3R,15350345,15350995,650
FBgn0266723,Trs31,2R,14757064,14757846,782
FBgn0266724,Trs20,3L,16131001,16131632,631
FBgn0266725,asRNA:CR45198,4,175455,175874,419
FBgn0266727,lncRNA:CR45200,4,776475,777146,671
FBgn0266729,asRNA:CR45202,2R,8897820,8898275,455
FBgn0266730,lncRNA:CR45203,3R,9483378,9484078,700
FBgn0266731,lncRNA:CR45204,X,10794338,10796292,1954
FBgn0266732,asRNA:CR45205,3R,10060666,10061978,1312
FBgn0266733,asRNA:CR45206,3R,15774076,15774715,639
FBgn0266735,asRNA:CR45208,3R,25661712,25662663,951
FBgn0266736,asRNA:CR45209,3R,27109329,27111033,1704
FBgn0266737,asRNA:CR45210,3L,19260040,19260895,855
FBgn0266739,lncRNA:CR45212,3R,16049031,16049421,390
FBgn0266741,asRNA:CR45214,3R,25266813,25270007,3194
FBgn0266742,lncRNA:CR45215,3R,8316984,8318006,1022
FBgn0266744,lncRNA:CR45217,3R,24229898,24231364,1466
FBgn0266745,CG45218,3R,15290309,15290799,490
FBgn0266748,lncRNA:CR45221,3R,16991978,16992976,998
FBgn0266750,lncRNA:CR45223,3R,17646903,17653478,6575
FBgn0266752,lncRNA:CR45225,3R,25675777,25676778,1001
FBgn0266756,btsz,3R,14804092,14875488,71396
FBgn0266757,mfr,3L,8905918,8912671,6753
FBgn0266758,Esyt2,3R,24544719,24556549,11830
FBgn0266768,lncRNA:CR45233,3L,14410117,14410698,581
FBgn0266776,lncRNA:CR45241,3L,16670355,16670741,386
FBgn0266777,lncRNA:CR45242,3L,10269482,10270353,871
FBgn0266778,lncRNA:CR45243,3L,20950359,20950783,424
FBgn0266786,lncRNA:CR45251,3L,11349395,11349743,348
FBgn0266787,lncRNA:CR45252,2R,24975377,24975887,510
FBgn0266801,CG45263,3R,8364328,8477617,113289
FBgn0266802,asRNA:CR45264,2R,12179014,12179745,731
FBgn0266805,lncRNA:CR45267,2R,8019176,8026595,7419
FBgn0266807,lncRNA:CR45269,2R,22666125,22666605,480
FBgn0266808,asRNA:CR45270,2R,17795886,17801924,6038
FBgn0266809,asRNA:CR45271,2R,12296495,12297805,1310
FBgn0266811,CG45273,2R,17131116,17131552,436
FBgn0266812,lncRNA:CR45274,2R,17584095,17584495,400
FBgn0266813,asRNA:CR45275,2R,17585692,17586243,551
FBgn0266817,lncRNA:CR45279,2R,12593195,12593827,632
FBgn0266818,lncRNA:CR45280,2R,7254602,7256696,2094
FBgn0266819,asRNA:CR45281,2R,9559255,9565190,5935
FBgn0266828,lncRNA:CR45290,2L,2188620,2189405,785
FBgn0266829,lncRNA:CR45291,2L,5060473,5060806,333
FBgn0266836,lncRNA:CR45298,2L,2044517,2045381,864
FBgn0266837,lncRNA:CR45299,2L,3508598,3509036,438
FBgn0266838,asRNA:CR45300,2L,3509099,3509440,341
FBgn0266843,asRNA:CR45305,2L,5070887,5071109,222
FBgn0266846,lncRNA:CR45308,2R,8558415,8558924,509
FBgn0266848,wap,X,22451445,22455422,3977
FBgn0266851,lncRNA:CR45312,2R,13361825,13362835,1010
FBgn0266860,lncRNA:CR45321,2R,9445265,9445784,519
FBgn0266863,lncRNA:CR45324,2R,9988125,9989285,1160
FBgn0266864,lncRNA:CR45325,2R,23720320,23721007,687
FBgn0266865,asRNA:CR45326,2R,23709177,23709947,770
FBgn0266866,lncRNA:CR45327,2R,22378263,22379007,744
FBgn0266869,asRNA:CR45330,2L,13241807,13244724,2917
FBgn0266871,lncRNA:CR45332,2L,17901807,17902691,884
FBgn0266872,lncRNA:CR45333,2L,17902778,17903073,295
FBgn0266880,asRNA:CR45341,2L,8370343,8370670,327
FBgn0266884,lncRNA:CR45345,2L,857403,860079,2676
FBgn0266886,lncRNA:CR45347,2L,20562247,20575720,13473
FBgn0266889,asRNA:CR45350,2R,24024098,24025777,1679
FBgn0266898,lncRNA:CR45358,2L,17575152,17575490,338
FBgn0266899,lncRNA:CR45359,2L,20489308,20490282,974
FBgn0266901,lncRNA:CR45361,2L,20484399,20487548,3149
FBgn0266906,asRNA:CR45366,2L,357329,358174,845
FBgn0266907,asRNA:CR45367,2L,355663,356891,1228
FBgn0266916,Cenp-C,3R,8564105,8569248,5143
FBgn0266917,Sf3a1,3R,16999384,17002355,2971
FBgn0266918,CG32486,3L,3055908,3070839,14931
FBgn0266925,asRNA:CR45376,2R,22201508,22203045,1537
FBgn0266927,lncRNA:CR45378,3L,392006,393255,1249
FBgn0266929,lncRNA:CR45380,3L,3329281,3329597,316
FBgn0266930,lncRNA:CR45381,3L,22643881,22644470,589
FBgn0266931,lncRNA:CR45382,3L,22473952,22474431,479
FBgn0266933,asRNA:CR45384,3L,20836112,20837135,1023
FBgn0266937,lncRNA:CR45388,3L,18852573,18861363,8790
FBgn0266945,asRNA:CR45396,3L,15142131,15142800,669
FBgn0266946,asRNA:CR45397,3L,15143801,15144170,369
FBgn0266953,lncRNA:CR45404,3L,11284731,11285180,449
FBgn0266954,lncRNA:CR45405,3L,11231307,11231588,281
FBgn0266958,lncRNA:CR45409,3L,8309351,8310512,1161
FBgn0266963,lncRNA:CR45414,3L,6936567,6937405,838
FBgn0266965,lncRNA:CR45416,3L,6883321,6883601,280
FBgn0266966,lncRNA:CR45417,3L,6728201,6728701,500
FBgn0266967,lncRNA:CR45418,3L,6608770,6609238,468
FBgn0266974,lncRNA:CR45425,3L,2503789,2504397,608
FBgn0266975,lncRNA:CR45426,3L,2319386,2319919,533
FBgn0266977,CG45428,3L,22836555,22837070,515
FBgn0266987,lncRNA:CR45438,3L,4626602,4626903,301
FBgn0266989,lncRNA:CR45440,3L,5984120,5984340,220
FBgn0266990,lncRNA:CR45441,3L,6059041,6059448,407
FBgn0266993,lncRNA:CR45444,3L,12337352,12337699,347
FBgn0266994,asRNA:CR45445,3L,13018315,13019110,795
FBgn0267001,Ten-a,X,12043698,12335214,291516
FBgn0267002,unc-104,2R,16751503,16772671,21168
FBgn0267003,lncRNA:CR45447,2L,13096994,13097298,304
FBgn0267011,lncRNA:CR45455,2L,19537965,19538223,258
FBgn0267012,lncRNA:CR45456,2L,9325845,9326721,876
FBgn0267013,lncRNA:CR45457,2L,9327039,9327553,514
FBgn0267017,lncRNA:CR45461,2L,13104719,13105263,544
FBgn0267019,lncRNA:CR45463,2L,6480661,6480930,269
FBgn0267022,asRNA:CR45466,X,20656891,20657678,787
FBgn0267023,asRNA:CR45467,2R,9881396,9882605,1209
FBgn0267025,asRNA:CR45469,2R,22874578,22875172,594
FBgn0267026,CR45470,2R,13410269,13410591,322
FBgn0267027,lncRNA:CR45471,2R,4730481,4731395,914
FBgn0267028,lncRNA:CR45472,2R,5663909,5664615,706
FBgn0267029,lncRNA:CR45473,X,140722,142197,1475
FBgn0267030,lncRNA:CR45474,X,620282,620729,447
FBgn0267031,lncRNA:CR45475,X,625247,625661,414
FBgn0267033,mamo,X,13846116,13990527,144411
FBgn0267035,asRNA:CR45479,X,2173480,2175855,2375
FBgn0267037,asRNA:CR45481,X,3968933,3972054,3121
FBgn0267041,asRNA:CR45485,X,16307032,16308687,1655
FBgn0267051,CR45495,X,19912655,19913283,628
FBgn0267053,CR45497,X,19931714,19932342,628
FBgn0267054,CR45498,X,19941530,19942158,628
FBgn0267057,asRNA:CR45501,X,19745936,19746487,551
FBgn0267058,lncRNA:CR45502,X,22958076,22958827,751
FBgn0267060,lncRNA:CR45504,X,20292047,20293407,1360
FBgn0267061,lncRNA:CR45505,X,20293601,20294288,687
FBgn0267073,lncRNA:CR45517,X,5428483,5429256,773
FBgn0267074,asRNA:CR45518,X,5516993,5517500,507
FBgn0267076,asRNA:CR45520,X,5663114,5665605,2491
FBgn0267078,lncRNA:CR45522,X,14786412,14787897,1485
FBgn0267081,asRNA:CR45525,X,5689852,5691172,1320
FBgn0267083,lncRNA:CR45527,X,15973555,15973917,362
FBgn0267084,asRNA:CR45528,X,5755492,5756710,1218
FBgn0267086,lncRNA:CR45530,X,6279680,6280012,332
FBgn0267087,lncRNA:CR45531,X,6860339,6863235,2896
FBgn0267089,lncRNA:CR45533,X,7445387,7450119,4732
FBgn0267090,lncRNA:CR45534,X,7487552,7488336,784
FBgn0267091,asRNA:CR45535,X,8084256,8085765,1509
FBgn0267102,lncRNA:CR45542,X,9590093,9590619,526
FBgn0267103,lncRNA:CR45543,X,9595082,9595467,385
FBgn0267108,CR45548,3R,27961443,27961821,378
FBgn0267109,asRNA:CR45549,3R,8233228,8233962,734
FBgn0267111,lncRNA:CR45551,3R,8225279,8232178,6899
FBgn0267112,lncRNA:CR45552,3R,30528280,30531861,3581
FBgn0267113,lncRNA:CR45553,3R,30530355,30532377,2022
FBgn0267116,lncRNA:CR45556,3R,32012648,32013408,760
FBgn0267118,lncRNA:CR45558,3R,4585178,4589308,4130
FBgn0267119,lncRNA:CR45559,3R,6892918,6893462,544
FBgn0267124,lncRNA:CR45564,3R,31687978,31688526,548
FBgn0267126,lncRNA:CR45566,3R,27924879,27925368,489
FBgn0267127,lncRNA:CR45567,3R,29022478,29024217,1739
FBgn0267137,lncRNA:CR45577,3R,10896479,10897181,702
FBgn0267142,lncRNA:CR45582,3R,12244989,12245353,364
FBgn0267148,lncRNA:CR45588,3R,5053181,5053738,557
FBgn0267151,lncRNA:CR45591,3R,13425833,13426178,345
FBgn0267157,lncRNA:CR45597,3R,4279673,4280057,384
FBgn0267160,asRNA:CR45600,3R,15136985,15140121,3136
FBgn0267161,asRNA:CR45601,X,10054235,10055109,874
FBgn0267163,CG45603,X,12274635,12275155,520
FBgn0267164,asRNA:CR45604,X,11089231,11095143,5912
FBgn0267171,asRNA:CR45611,X,21373635,21374417,782
FBgn0267172,asRNA:CR45612,X,21372593,21373553,960
FBgn0267174,lncRNA:CR45614,X,11065860,11066377,517
FBgn0267176,lncRNA:CR45616,X,10891432,10891973,541
FBgn0267177,lncRNA:CR45617,X,10892261,10892748,487
FBgn0267180,asRNA:CR45620,X,7959274,7960898,1624
FBgn0267181,asRNA:CR45621,X,12612108,12615780,3672
FBgn0267189,asRNA:CR45629,X,10217627,10219303,1676
FBgn0267199,lncRNA:CR45639,3R,16208192,16208935,743
FBgn0267201,lncRNA:CR45641,3R,16214278,16214957,679
FBgn0267206,lncRNA:CR45646,3R,22539996,22541279,1283
FBgn0267207,lncRNA:CR45647,3R,22543278,22543578,300
FBgn0267210,lncRNA:CR45650,3R,24767728,24768484,756
FBgn0267211,lncRNA:CR45651,3R,25503378,25504478,1100
FBgn0267219,lncRNA:CR45659,3L,22840293,22841302,1009
FBgn0267220,lncRNA:CR45660,3L,2629834,2630693,859
FBgn0267222,lncRNA:CR45662,3R,24282911,24283368,457
FBgn0267223,asRNA:CR45663,3L,16318941,16319263,322
FBgn0267228,lncRNA:CR45668,X,5882480,5899989,17509
FBgn0267229,lncRNA:CR45669,3R,28970541,28972750,2209
FBgn0267233,lncRNA:CR45673,3R,4634975,4635655,680
FBgn0267234,lncRNA:CR45674,3L,21318223,21318650,427
FBgn0267236,CG45676,3R,11418885,11419295,410
FBgn0267237,lncRNA:CR45677,3L,20395394,20395851,457
FBgn0267239,lncRNA:CR45679,3R,13443070,13444076,1006
FBgn0267240,lncRNA:CR45680,3R,13617750,13618559,809
FBgn0267241,lncRNA:CR45681,3L,12490294,12491196,902
FBgn0267242,asRNA:CR45682,3L,12491840,12493605,1765
FBgn0267243,asRNA:CR45683,2L,13437895,13442410,4515
FBgn0267244,lncRNA:CR45684,2L,13458290,13458605,315
FBgn0267246,asRNA:CR45686,3L,1806043,1806932,889
FBgn0267252,Ggamma30A,2L,9256563,9302494,45931
FBgn0267253,CG32700,X,9502826,9550838,48012
FBgn0267257,lncRNA:CR45693,2L,14509913,14512083,2170
FBgn0267262,lncRNA:CR45698,2L,17579478,17580006,528
FBgn0267265,asRNA:CR45701,2L,19964045,19964347,302
FBgn0267270,lncRNA:CR45706,2L,3264168,3265714,1546
FBgn0267276,asRNA:CR45712,2L,2006867,2007688,821
FBgn0267277,asRNA:CR45713,2L,21232745,21234035,1290
FBgn0267278,asRNA:CR45714,X,18480072,18481132,1060
FBgn0267280,CR45716,2L,4891327,4891845,518
FBgn0267281,lncRNA:CR45717,2L,1142869,1143216,347
FBgn0267295,lncRNA:CR45731,3L,19504986,19505295,309
FBgn0267298,lncRNA:CR45734,3L,20920802,20921073,271
FBgn0267302,asRNA:CR45738,3L,4240069,4240505,436
FBgn0267309,lncRNA:CR45745,3L,10978011,10978302,291
FBgn0267310,lncRNA:CR45746,3L,12195787,12196049,262
FBgn0267322,lncRNA:CR45758,3L,22960930,22961668,738
FBgn0267323,lncRNA:CR45759,3L,6786660,6787105,445
FBgn0267326,Ntl,2L,7710880,7713991,3111
FBgn0267330,KdelR,2L,10426887,10428632,1745
FBgn0267336,Glut4EF,3R,9874681,9995364,120683
FBgn0267337,rn,3R,7272617,7309629,37012
FBgn0267339,p38c,3R,24149020,24150203,1183
FBgn0267347,squ,2L,16680054,16681653,1599
FBgn0267348,LanB2,3L,9614914,9623980,9066
FBgn0267350,Pi4KIIIalpha,X,2624804,2633672,8868
FBgn0267351,Topors,2R,18972612,18977262,4650
FBgn0267363,JYalpha,4,879,5039,4160
FBgn0267365,l(2)SH0834,2L,10311050,10312099,1049
FBgn0267366,mil,3R,27912447,27913785,1338
FBgn0267376,SelR,3R,10863355,10868642,5287
FBgn0267378,sau,2L,2226342,2231099,4757
FBgn0267383,Ubc87F,3R,13717454,13718176,722
FBgn0267384,Ubc7,X,16593677,16595867,2190
FBgn0267385,Pyk,3R,22367536,22372746,5210
FBgn0267390,dop,3L,15566013,15576313,10300
FBgn0267398,Yeti,2R,1343403,1345119,1716
FBgn0267408,AOX1,3R,15532137,15537292,5155
FBgn0267425,asRNA:CR45778,2L,11011162,11012135,973
FBgn0267428,DIP-lambda,2R,326768,705848,379080
FBgn0267429,lovit,3L,25236940,25670980,434040
FBgn0267430,Pzl,3R,2554162,3263582,709420
FBgn0267431,Myo81F,3R,567076,2532932,1965856
FBgn0267435,chp,3R,31204180,31210730,6550
FBgn0267439,asRNA:CR45789,2L,10392867,10393434,567
FBgn0267443,lncRNA:CR45793,3R,5263757,5264511,754
FBgn0267447,asRNA:CR45797,X,487898,488333,435
FBgn0267448,asRNA:CR45798,3R,21266255,21267794,1539
FBgn0267450,asRNA:CR45800,3R,20325529,20326260,731
FBgn0267451,asRNA:CR45801,3L,21028959,21029701,742
FBgn0267452,asRNA:CR45802,3L,2118498,2119567,1069
FBgn0267453,lncRNA:CR45803,3L,21950101,21951548,1447
FBgn0267454,asRNA:CR45804,3L,9693821,9694705,884
FBgn0267455,lncRNA:CR45805,3L,130730,131571,841
FBgn0267456,asRNA:CR45806,3L,175138,176104,966
FBgn0267457,asRNA:CR45807,3L,599399,600914,1515
FBgn0267458,lncRNA:CR45808,3L,553216,553739,523
FBgn0267459,lncRNA:CR45809,3L,961769,962471,702
FBgn0267460,lncRNA:CR45810,3L,962756,963099,343
FBgn0267461,lncRNA:CR45811,3L,1001027,1002195,1168
FBgn0267462,asRNA:CR45812,3L,1494499,1495119,620
FBgn0267463,asRNA:CR45813,3L,1549448,1549900,452
FBgn0267464,asRNA:CR45814,3L,1617485,1618190,705
FBgn0267465,asRNA:CR45815,3L,1648628,1649699,1071
FBgn0267469,lncRNA:CR45819,3L,3137599,3138012,413
FBgn0267471,lncRNA:CR45821,3L,4792615,4793717,1102
FBgn0267472,asRNA:CR45822,3L,7355717,7356598,881
FBgn0267475,lncRNA:CR45825,3L,13550874,13551808,934
FBgn0267477,asRNA:CR45827,3L,1963143,1964285,1142
FBgn0267478,asRNA:CR45828,3L,1963213,1963700,487
FBgn0267480,asRNA:CR45830,3L,4655405,4656330,925
FBgn0267481,asRNA:CR45831,3L,5767321,5768704,1383
FBgn0267482,asRNA:CR45832,3L,7037825,7038347,522
FBgn0267483,lncRNA:CR45833,3L,7350404,7350802,398
FBgn0267485,asRNA:CR45835,3L,7361639,7363598,1959
FBgn0267486,Ptp36E,2L,18180884,18185007,4123
FBgn0267487,Ptp61F,3L,1342493,1475257,132764
FBgn0267488,Mcr,2L,8074117,8082982,8865
FBgn0267495,asRNA:CR45185,X,10044909,10048156,3247
FBgn0267496,2SrRNA:CR45836,rDNA,46356,46385,29
FBgn0267497,28SrRNA:CR45837,rDNA,46771,49485,2714
FBgn0267498,18SrRNA:CR45838,rDNA,55965,57959,1994
FBgn0267499,5.8SrRNA:CR45839,rDNA,58654,58776,122
FBgn0267500,2SrRNA:CR45840,rDNA,58805,58834,29
FBgn0267501,18SrRNA:CR45841,rDNA,67668,69662,1994
FBgn0267502,5.8SrRNA:CR45842,rDNA,70389,70511,122
FBgn0267503,2SrRNA:CR45843,rDNA,70540,70569,29
FBgn0267504,28SrRNA:CR45844,rDNA,70955,74924,3969
FBgn0267505,pre-rRNA:CR45845,rDNA,42623,49485,6862
FBgn0267506,pre-rRNA:CR45846,rDNA,55104,59294,4190
FBgn0267507,pre-rRNA:CR45847,rDNA,66807,74924,8117
FBgn0267508,28SrRNA-Psi:CR45848,rDNA,4492,5312,820
FBgn0267511,28SrRNA-Psi:CR45851,rDNA,35941,38740,2799
FBgn0267512,5.8SrRNA:CR45852,rDNA,46205,46327,122
FBgn0267515,28SrRNA-Psi:CR45855,X,23205822,23206525,703
FBgn0267516,pre-rRNA:CR45856,X,23278007,23283731,5724
FBgn0267519,28SrRNA-Psi:CR45859,X,23214452,23217140,2688
FBgn0267520,28SrRNA-Psi:CR45860,X,23270802,23271158,356
FBgn0267521,18SrRNA-Psi:CR45861,X,23280998,23282931,1933
FBgn0267522,28SrRNA-Psi:CR45862,X,23278007,23280010,2003
FBgn0267525,asRNA:CR45865,3L,16612500,16612827,327
FBgn0267529,asRNA:CR45869,3L,8183583,8183998,415
FBgn0267530,asRNA:CR45870,3L,8184252,8185221,969
FBgn0267532,asRNA:CR45872,3L,9438984,9439450,466
FBgn0267533,asRNA:CR45873,3L,9456339,9457296,957
FBgn0267534,asRNA:CR45874,3L,9510017,9510889,872
FBgn0267535,asRNA:CR45875,3L,9890816,9892109,1293
FBgn0267536,lncRNA:CR45876,3L,9991736,9992583,847
FBgn0267538,lncRNA:CR45878,3L,10048302,10048927,625
FBgn0267540,lncRNA:CR45880,3L,11667278,11667898,620
FBgn0267541,lncRNA:CR45881,3L,11666319,11667079,760
FBgn0267542,asRNA:CR45882,3L,11668211,11668877,666
FBgn0267543,lncRNA:CR45883,3L,11667284,11667825,541
FBgn0267545,asRNA:CR45885,3L,11687344,11688390,1046
FBgn0267549,asRNA:CR45889,3L,16042395,16042968,573
FBgn0267551,asRNA:CR45891,3R,15802854,15803495,641
FBgn0267552,asRNA:CR45892,3L,12132455,12133605,1150
FBgn0267553,lncRNA:CR45893,3L,16343189,16345241,2052
FBgn0267554,asRNA:CR45894,3L,16353498,16353916,418
FBgn0267555,asRNA:CR45895,3L,16587111,16587805,694
FBgn0267556,asRNA:CR45896,3L,7510942,7513354,2412
FBgn0267557,lncRNA:CR45897,3L,16700829,16701469,640
FBgn0267567,asRNA:CR45907,3R,7085660,7086140,480
FBgn0267568,asRNA:CR45908,3R,7074776,7075487,711
FBgn0267570,lncRNA:CR45910,3R,25586442,25589179,2737
FBgn0267571,lncRNA:CR45911,3R,15417320,15420710,3390
FBgn0267576,lncRNA:CR45916,3L,19562636,19566533,3897
FBgn0267578,lncRNA:CR45918,2R,9310329,9313237,2908
FBgn0267579,lncRNA:CR45919,2L,17560813,17566551,5738
FBgn0267581,lncRNA:CR45921,3L,17981321,17981841,520
FBgn0267585,lncRNA:dntRL,2R,4621118,4622481,1363
FBgn0267586,asRNA:CR45924,2R,9075158,9075951,793
FBgn0267587,asRNA:CR45925,2R,19396500,19396849,349
FBgn0267588,asRNA:CR45926,2R,23905334,23906700,1366
FBgn0267589,asRNA:CR45927,2R,15540887,15541300,413
FBgn0267590,asRNA:CR45928,2R,23850330,23851500,1170
FBgn0267591,asRNA:CR45929,X,1900768,1901162,394
FBgn0267599,lncRNA:CR45937,3L,18234246,18234760,514
FBgn0267600,lncRNA:CR45938,3L,18753797,18754085,288
FBgn0267601,lncRNA:CR45939,3L,18772086,18801312,29226
FBgn0267602,lncRNA:CR45940,3L,19033317,19033900,583
FBgn0267603,lncRNA:CR45941,3L,19183998,19184726,728
FBgn0267605,asRNA:CR45943,3L,20838313,20838700,387
FBgn0267606,asRNA:CR45944,3L,21003707,21004201,494
FBgn0267611,lncRNA:CR45949,2L,9948908,9951122,2214
FBgn0267613,asRNA:CR45951,3L,21194617,21196136,1519
FBgn0267614,asRNA:CR45952,3L,21302421,21304135,1714
FBgn0267615,lncRNA:CR45953,3L,21398317,21398941,624
FBgn0267616,lncRNA:CR45954,3L,21413303,21413643,340
FBgn0267617,asRNA:CR45955,3L,21636643,21637314,671
FBgn0267622,asRNA:CR45960,3L,22274083,22275716,1633
FBgn0267623,lncRNA:CR45961,3L,22756796,22757328,532
FBgn0267624,lncRNA:CR45962,3L,22348168,22407547,59379
FBgn0267627,lncRNA:CR45965,3L,22359458,22360868,1410
FBgn0267630,asRNA:CR45968,3L,22872380,22873723,1343
FBgn0267631,asRNA:CR45969,3L,22871813,22872107,294
FBgn0267632,asRNA:CR45970,3L,22879259,22880399,1140
FBgn0267635,lncRNA:CR45973,3L,20404270,20407558,3288
FBgn0267637,lncRNA:CR45975,3L,18302801,18303341,540
FBgn0267638,lncRNA:CR45976,3L,17696391,17696967,576
FBgn0267641,lncRNA:CR45979,3L,6505569,6506393,824
FBgn0267643,lncRNA:CR45981,3L,2621721,2622629,908
FBgn0267647,lncRNA:CR45985,3L,5142520,5142780,260
FBgn0267648,pre-mod(mdg4)-G,3R,21354445,21359768,5323
FBgn0267649,pre-mod(mdg4)-H,3R,21354445,21359768,5323
FBgn0267650,pre-mod(mdg4)-AA,3R,21370918,21373575,2657
FBgn0267651,pre-mod(mdg4)-O,3R,21370918,21373575,2657
FBgn0267652,pre-mod(mdg4)-N,3R,21370918,21373575,2657
FBgn0267656,lncRNA:CR45994,2R,16153906,16154551,645
FBgn0267657,asRNA:CR45995,X,14181113,14182716,1603
FBgn0267659,lncRNA:CR45997,2R,17262339,17262748,409
FBgn0267661,asRNA:CR45999,3R,4395549,4397548,1999
FBgn0267665,lncRNA:CR46003,3L,10286945,10307968,21023
FBgn0267666,lncRNA:CR46004,3L,10306678,10320600,13922
FBgn0267667,asRNA:CR46005,3L,6125398,6132074,6676
FBgn0267668,lncRNA:CR46006,3L,10323501,10367450,43949
FBgn0267673,lncRNA:CR46009,3R,11354348,11355123,775
FBgn0267676,asRNA:CR46012,3R,12221039,12221630,591
FBgn0267677,lncRNA:CR46013,3R,12266104,12266610,506
FBgn0267679,lncRNA:CR46015,3R,12370507,12371099,592
FBgn0267684,asRNA:CR46020,3R,14264829,14265535,706
FBgn0267687,lncRNA:CR46023,3R,14535245,14536223,978
FBgn0267689,CG46025,2L,7754174,7765915,11741
FBgn0267693,asRNA:CR46029,3R,16473229,16480850,7621
FBgn0267697,asRNA:CR46033,3L,16663903,16664913,1010
FBgn0267698,Pak,3R,6350896,6361614,10718
FBgn0267702,lncRNA:CR46035,3R,17703695,17705581,1886
FBgn0267703,lncRNA:CR46036,3R,17700741,17701873,1132
FBgn0267704,lncRNA:flam,X,21631891,21790731,158840
FBgn0267705,asRNA:CR46038,3R,10122422,10124412,1990
FBgn0267706,lncRNA:CR46039,3R,19191981,19193028,1047
FBgn0267708,lncRNA:CR46041,3R,19058020,19058519,499
FBgn0267711,asRNA:CR46044,3R,20588003,20588549,546
FBgn0267712,asRNA:CR46045,3R,21102008,21102889,881
FBgn0267715,asRNA:CR46048,3L,19294727,19295198,471
FBgn0267717,asRNA:CR46050,3L,11229029,11229437,408
FBgn0267722,asRNA:CR46055,3R,21632705,21633322,617
FBgn0267725,asRNA:CR46058,3R,15402982,15403707,725
FBgn0267726,CG46059,2L,19183093,19183787,694
FBgn0267728,otk2,2R,12023146,12025272,2126
FBgn0267729,lncRNA:CR46060,3R,26124809,26125423,614
FBgn0267730,lncRNA:CR46061,3R,26235325,26252932,17607
FBgn0267733,lncRNA:CR46064,2R,4782892,4785543,2651
FBgn0267734,asRNA:CR46065,4,228576,229112,536
FBgn0267735,asRNA:CR46066,2L,21665849,21666851,1002
FBgn0267736,asRNA:CR46067,3L,14053100,14054304,1204
FBgn0267737,asRNA:CR46068,3L,21333010,21333511,501
FBgn0267739,asRNA:CR46070,2L,12040782,12041515,733
FBgn0267742,lncRNA:CR46073,3R,26847809,26849236,1427
FBgn0267743,asRNA:CR46074,2L,7724576,7724976,400
FBgn0267744,lncRNA:CR46075,2R,6501032,6501772,740
FBgn0267750,asRNA:CR46081,3R,15275601,15276217,616
FBgn0267751,asRNA:CR46082,3R,30135008,30137581,2573
FBgn0267753,lncRNA:CR46084,3R,26541292,26543209,1917
FBgn0267754,lncRNA:CR46085,3R,27245333,27245701,368
FBgn0267758,asRNA:CR46089,3R,23052916,23057984,5068
FBgn0267759,lncRNA:CR46090,3R,23333504,23333803,299
FBgn0267761,asRNA:CR46092,3R,23957305,23958388,1083
FBgn0267762,asRNA:CR46093,3R,24318816,24319782,966
FBgn0267763,lncRNA:CR46094,3R,24573770,24574304,534
FBgn0267764,lncRNA:CR46095,3R,24607271,24607795,524
FBgn0267765,asRNA:CR46096,3R,24815759,24817131,1372
FBgn0267767,lncRNA:CR46098,3R,25137701,25138001,300
FBgn0267768,asRNA:CR46099,3R,25262182,25262636,454
FBgn0267770,asRNA:CR46101,3R,25657393,25658274,881
FBgn0267773,asRNA:CR46104,3R,28336889,28337629,740
FBgn0267774,asRNA:CR46105,3R,28340412,28340800,388
FBgn0267776,asRNA:CR46107,3R,29054343,29055703,1360
FBgn0267777,lncRNA:CR46108,3R,29719713,29721191,1478
FBgn0267778,asRNA:CR46109,3R,29745209,29746083,874
FBgn0267779,lncRNA:CR46110,3R,29774324,29775051,727
FBgn0267780,lncRNA:CR46111,3R,30026218,30026872,654
FBgn0267781,lncRNA:CR46112,3R,30106997,30107532,535
FBgn0267786,lncRNA:CR46117,3R,30992803,30993615,812
FBgn0267790,rump,3R,9505853,9510324,4471
FBgn0267791,HnRNP-K,2R,20587551,20606854,19303
FBgn0267792,rgr,2R,8600415,8612295,11880
FBgn0267793,lncRNA:CR45232,2R,16297449,16306695,9246
FBgn0267794,lncRNA:CR43174,3L,17934032,17946114,12082
FBgn0267795,Frl,3L,14053215,14071583,18368
FBgn0267796,Tmc,3L,9597764,9614001,16237
FBgn0267798,lncRNA:CR46123,3R,1366234,1366601,367
FBgn0267800,lncRNA:CR46125,3R,8460241,8461200,959
FBgn0267801,lncRNA:CR46126,3R,8413803,8414185,382
FBgn0267802,lncRNA:CR46127,3R,7883693,7884441,748
FBgn0267803,asRNA:CR46128,3R,7537842,7541279,3437
FBgn0267804,asRNA:CR46129,3R,7544843,7545250,407
FBgn0267808,asRNA:CR46133,3R,5858195,5858894,699
FBgn0267809,asRNA:CR46134,3R,5662901,5665032,2131
FBgn0267810,asRNA:CR46135,3R,5613280,5616308,3028
FBgn0267811,asRNA:CR46136,3R,5560472,5561573,1101
FBgn0267812,asRNA:CR46137,3R,4737500,4737908,408
FBgn0267813,asRNA:CR46138,3R,4434624,4436101,1477
FBgn0267814,asRNA:CR46139,3R,4393350,4394493,1143
FBgn0267815,asRNA:CR46140,3R,4309944,4310869,925
FBgn0267817,lncRNA:CR46142,3R,7997606,7998352,746
FBgn0267818,lncRNA:CR46143,3R,7995985,7997435,1450
FBgn0267819,asRNA:CR46144,3R,9795008,9796050,1042
FBgn0267820,asRNA:CR46145,3R,9393890,9394737,847
FBgn0267821,da,2L,10388105,10393228,5123
FBgn0267823,Gmer,2R,22887574,22888857,1283
FBgn0267824,PRAS40,2R,14481187,14497312,16125
FBgn0267828,Fatp1,2L,10510672,10517218,6546
FBgn0267468,asRNA:CR45818,3L,1796854,1797272,418
FBgn0267849,Syx7,3L,21445834,21448128,2294
FBgn0267861,Maf1,2R,1512810,1527095,14285
FBgn0267866,CR46154,3R,12504977,12505250,273
FBgn0267867,CR46155,3R,12508260,12508533,273
FBgn0267910,lncRNA:CR34335,X,3545750,3546110,360
FBgn0267912,CanA-14F,X,16560684,16587172,26488
FBgn0267913,asRNA:CR46194,2R,12169558,12171706,2148
FBgn0267914,asRNA:CR46195,X,8564408,8565178,770
FBgn0267923,lncRNA:CR46204,2L,17450494,17452384,1890
FBgn0267927,lncRNA:CR46208,2L,9663744,9668501,4757
FBgn0267959,lncRNA:CR46239,3R,13864597,13865095,498
FBgn0267964,CG46244,2L,19606569,19731561,124992
FBgn0267966,asRNA:CR46246,3L,9597171,9598375,1204
FBgn0267967,corolla,X,17629791,17632047,2256
FBgn0267972,Der-1,2L,1973957,1975413,1456
FBgn0267975,vib,3R,19215434,19226651,11217
FBgn0267976,Tim23,2L,23312465,23313578,1113
FBgn0267977,mh,X,15472804,15475400,2596
FBgn0267978,ap,2R,5706202,5727525,21323
FBgn0267984,asRNA:CR46251,3L,12806687,12808545,1858
FBgn0267987,lncRNA:CR46254,2L,54817,55767,950
FBgn0267988,asRNA:CR46255,3R,4235294,4235973,679
FBgn0267989,asRNA:CR46256,2L,13174227,13175365,1138
FBgn0267990,lncRNA:CR46257,2R,9578905,9579271,366
FBgn0267991,lncRNA:CR46258,2L,490835,492649,1814
FBgn0267995,asRNA:CR46262,2L,283807,284255,448
FBgn0267996,asRNA:CR46263,2L,286383,288292,1909
FBgn0268063,ltl,3L,7518997,7528013,9016
FBgn0270924,zf30C,2L,9758342,9762375,4033
FBgn0270925,CG4836,3R,20013872,20018248,4376
FBgn0270926,AsnS,3L,21173118,21174973,1855
FBgn0270927,betaGlu,3R,31769293,31771848,2555
FBgn0270928,VAChT,3R,18705501,18718916,13415
FBgn0275434,asRNA:CR46266,3L,13840611,13842198,1587
FBgn0275436,PheRS-m,2R,13968308,13969902,1594
FBgn0278598,lncRNA:CR46268,2L,22538230,22548452,10222
FBgn0278599,asRNA:CR46269,2R,5957588,5959299,1711
FBgn0278604,dmt,3R,9711142,9714675,3533
FBgn0278608,Dsp1,X,16333612,16340624,7012
FBgn0283427,FASN1,2L,3056598,3068177,11579
FBgn0283428,lncRNA:CR46271,2R,18541144,18542454,1310
FBgn0283429,CR46272,X,20202076,20203054,978
FBgn0283430,CR46273,X,20209746,20210724,978
FBgn0283431,CR46274,X,20217402,20218376,974
FBgn0283432,SdicA,X,20197319,20201933,4614
FBgn0283433,SdicB,X,20205043,20209603,4560
FBgn0283434,SdicC,X,20212738,20217259,4521
FBgn0283437,PPO1,2R,17887220,17889973,2753
FBgn0283438,CG46280,3R,13026283,13030659,4376
FBgn0283439,CG46281,3R,13028920,13030307,1387
FBgn0283440,solo,2L,15061656,15072133,10477
FBgn0283442,vas,2L,15061656,15074311,12655
FBgn0283450,Glo1,2R,7393546,7395932,2386
FBgn0283451,br,X,1575132,1664869,89737
FBgn0283461,Drs,3L,3369556,3369942,386
FBgn0283467,PolD3,2L,15254819,15256304,1485
FBgn0283468,slmb,3R,21119252,21127485,8233
FBgn0283469,Vps4,X,17907692,17911097,3405
FBgn0283471,wupA,X,18105568,18116922,11354
FBgn0283472,S6k,3L,5797549,5810931,13382
FBgn0283473,S6KL,X,18788464,18806057,17593
FBgn0283476,Dhc16F,X,18064483,18078472,13989
FBgn0283477,SF2,3R,16338943,16341988,3045
FBgn0283478,und,2L,9763369,9765338,1969
FBgn0283479,Alp1,3L,21442227,21444819,2592
FBgn0283494,Ak2,2R,24024207,24025877,1670
FBgn0283499,InR,3R,21570248,21619321,49073
FBgn0283500,Sac1,3L,1247817,1250451,2634
FBgn0283503,Neurl4,3L,14043694,14049892,6198
FBgn0283508,nw,2R,17502354,17508645,6291
FBgn0283509,Phm,2R,23985175,23988455,3280
FBgn0283510,Pal1,2R,9959549,9963853,4304
FBgn0283521,lola,2R,10481894,10543291,61397
FBgn0283525,l(2)10685,2L,1147822,1149449,1627
FBgn0283531,Duox,2L,2815970,2830248,14278
FBgn0283535,Vha26,3R,5591763,5595356,3593
FBgn0283536,Vha13,3R,19643018,19644386,1368
FBgn0283545,vilya,X,2726678,2727568,890
FBgn0283625,CG46298,2R,10353368,10354389,1021
FBgn0283649,elgi,3L,15956550,15958433,1883
FBgn0283651,CG46301,2L,14104090,14160587,56497
FBgn0283652,Rpp30,2L,251039,252373,1334
FBgn0283657,Tlk,X,3720007,3789770,69763
FBgn0283658,muc,2L,7426866,7430329,3463
FBgn0283659,Thg,2L,15008489,15009724,1235
FBgn0283666,Rap2l,2R,24063051,24065405,2354
FBgn0283680,IP3K2,X,13303633,13329303,25670
FBgn0283681,Tcs3,3L,16351991,16353286,1295
FBgn0283682,Ge-1,2L,11095150,11100888,5738
FBgn0283712,LIMK1,X,12584385,12592193,7808
FBgn0283724,Girdin,3L,3178930,3185287,6357
FBgn0283741,prage,X,1773719,1853667,79948
FBgn0284080,CG46302,2R,854814,855571,757
FBgn0284081,CG46303,3R,5821972,5822435,463
FBgn0284083,CG46305,2R,10351533,10352161,628
FBgn0284084,wg,2L,7307159,7316265,9106
FBgn0284220,Top2,2L,19447365,19453490,6125
FBgn0284221,Sema5c,3L,12067511,12081830,14319
FBgn0284222,CG46306,X,16826681,16835520,8839
FBgn0284223,CG46307,2L,21104568,21132909,28341
FBgn0284224,CG46308,2L,13461774,13500427,38653
FBgn0284225,CG46309,2L,16245835,16251788,5953
FBgn0284226,CG46310,3R,23173873,23185642,11769
FBgn0284227,CG46311,X,13563823,13590570,26747
FBgn0284228,CG46312,X,15987166,15991974,4808
FBgn0284229,CG46313,3R,26978541,26985706,7165
FBgn0284230,CG46314,2L,21314360,21319527,5167
FBgn0284231,CG46315,2R,17703335,17719346,16011
FBgn0284232,CG46316,3R,24712780,24717430,4650
FBgn0284233,CG46317,X,14261223,14264844,3621
FBgn0284234,CG46318,3R,18680604,18685290,4686
FBgn0284235,CG46319,2R,10124293,10137472,13179
FBgn0284236,CG46320,3L,5664121,5749599,85478
FBgn0284237,CG46321,2R,10205454,10227957,22503
FBgn0284238,lncRNA:CR46322,2R,10209724,10211347,1623
FBgn0284243,betaTub56D,2R,19447319,19451600,4281
FBgn0284244,l(2)k05911,2L,13251509,13257426,5917
FBgn0284245,eEF1alpha1,2R,11891135,11895762,4627
FBgn0284246,l(2)k09848,2R,6074471,6076367,1896
FBgn0284247,ds,2L,640013,714983,74970
FBgn0284248,Cyt-c-p,2L,16719932,16722644,2712
FBgn0284249,Adf1,2R,6662265,6668085,5820
FBgn0284251,l(2)05287,2L,21094966,21102429,7463
FBgn0284252,Letm1,2R,24509508,24515320,5812
FBgn0284253,LeuRS,2L,3510328,3514656,4328
FBgn0284254,Impbeta11,2R,15682719,15687415,4696
FBgn0284255,Arpc4,2L,6125132,6125911,779
FBgn0284256,bsf,2L,18449517,18454587,5070
FBgn0284257,Ttd14,2R,18430315,18440475,10160
FBgn0284408,trol,X,2470460,2545427,74967
FBgn0284421,Psn,3L,20432468,20435156,2688
FBgn0284435,tyn,X,140318,200663,60345
FBgn0284436,CCT8,2R,8904844,8906990,2146
FBgn0284442,Mcm3,X,5323855,5326738,2883
FBgn0284444,ddbt,3L,317084,317789,705
FBgn0285879,disco-r,X,16118067,16148977,30910
FBgn0285892,tea,2R,9891955,9898513,6558
FBgn0285896,btl,3L,14075772,14083229,7457
FBgn0285910,VhaAC39-1,X,3880748,3882967,2219
FBgn0285911,Vps16A,3R,9267019,9270224,3205
FBgn0285912,mah,3R,24947632,24949539,1907
FBgn0285913,red,3R,14289071,14302276,13205
FBgn0285917,sbb,2R,18278198,18357296,79098
FBgn0285925,Fas1,3R,16625238,16639771,14533
FBgn0285926,Imp,X,10787869,10824277,36408
FBgn0285937,Rab1,3R,21266029,21269060,3031
FBgn0285943,knon,2R,16496889,16499429,2540
FBgn0285944,para,X,16455027,16533096,78069
FBgn0285947,RpS10b,X,19598031,19599806,1775
FBgn0285948,RpL27A,2L,4457186,4458364,1178
FBgn0285949,RpL31,2R,9587193,9587989,796
FBgn0285950,RpL19,2R,24967877,24969547,1670
FBgn0285951,mRpS34,3L,16348074,16348782,708
FBgn0285952,eEF5,2R,24057798,24059483,1685
FBgn0285954,caz,X,16288810,16293520,4710
FBgn0285955,cv-c,3R,14391683,14481713,90030
FBgn0285958,Fuca,3L,11518798,11522713,3915
FBgn0285959,sisRNA:1,3R,5609245,5609611,366
FBgn0285963,CG46339,3R,26915761,26945309,29548
FBgn0285970,CG32500,X,21621541,21623750,2209
FBgn0285971,prg,2L,8464488,8466694,2206
FBgn0285991,hpRNA:CR18854,2L,9787294,9790745,3451
FBgn0285992,hpRNA:CR46342,X,4921677,4928133,6456
FBgn0285994,hpRNA:CR46340,3L,21576445,21576683,238
FBgn0286027,Rnmt,2L,15009939,15011764,1825
FBgn0286028,lncRNA:CR46348,3L,22570364,22572033,1669
FBgn0286029,lncRNA:CR46349,X,4074961,4075428,467
FBgn0286031,lncRNA:CR46351,3R,12645719,12646077,358
FBgn0286032,lncRNA:CR46352,3R,5042652,5043025,373
FBgn0286034,asRNA:CR46354,3R,13459671,13466106,6435
FBgn0286035,sisRNA:CR46357,3R,9630255,9630440,185
FBgn0286036,sisRNA:CR46358,3R,4639789,4640004,215
FBgn0286037,sisRNA:3,3L,22269932,22270220,288
FBgn0286040,sisRNA:2,X,16612777,16613274,497
FBgn0286042,sisRNA:CR46364,3R,25246874,25247422,548
FBgn0286051,Rexo5,3L,6603684,6608739,5055
FBgn0286070,cnk,2R,17413970,17420007,6037
FBgn0286071,AdamTS-A,3R,15442246,15476193,33947
FBgn0286075,DNAlig3,3R,12399011,12401839,2828
FBgn0286198,LKRSDH,2L,7791175,7795959,4784
FBgn0286199,shps,3R,24279572,24281576,2004
FBgn0286203,stw,2R,5413744,5456095,42351
FBgn0286213,RpS12,3L,13023352,13024762,1410
FBgn0286222,Fum1,X,6678424,6681845,3421
FBgn0286506,Mpi,3R,9759622,9761208,1586
FBgn0286507,vrs,3R,12447653,12449046,1393
FBgn0286508,Had1,X,16306912,16308667,1755
FBgn0286511,Pld,2R,6242004,6255266,13262
FBgn0286516,aqz,3R,8813490,8820682,7192
FBgn0286567,gry,3L,3199090,3211348,12258
FBgn0286723,hll,2L,14027001,14029368,2367
FBgn0286729,snoRNA:Or-CD15,3L,1667151,1667247,96
FBgn0286737,snoRNA:Or-CD16,2L,3504032,3504182,150
FBgn0286738,scaRNA:MeU4:25F-C137,3R,5584502,5584644,142
FBgn0286739,snoRNA:Me28S-C993,3L,10196162,10196254,92
FBgn0286758,snoRNA:Me18S-G1358c,3L,27267383,27267450,67
FBgn0286778,CG46385,2R,7737019,7782637,45618
FBgn0286781,cass,2L,17474912,17477888,2976
FBgn0286782,flz,2R,8969346,8985900,16554
FBgn0286783,Etf-QO,2R,9910893,9913488,2595
FBgn0286784,TER94,2R,9989159,9993559,4400
FBgn0286785,scb,2R,15248784,15258498,9714
FBgn0286786,hoip,2L,9699791,9700459,668
FBgn0286788,Orc1,2R,7522437,7525716,3279
FBgn0286809,xmas,X,17151231,17159306,8075
FBgn0286813,SRPK,2R,15380724,15387851,7127
FBgn0286818,Pdi,3L,15137738,15142840,5102
FBgn0286827,lncRNA:CR43334,3L,628435,643900,15465
FBgn0286828,dind,3R,18674626,18677539,2913
FBgn0286833,CG46387,3L,9898626,9899387,761
FBgn0286852,naz,3R,18316075,18328942,12867
FBgn0286868,lncRNA:SMRG,X,12680687,12682560,1873
FBgn0286870,lncRNA:enrr,X,513106,523226,10120
FBgn0286871,lncRNA:CR46393,3R,19212154,19212727,573
FBgn0286875,CG46397,2L,8947266,8947871,605
FBgn0286878,sbRNA:1,X,16633124,16633208,84
FBgn0286879,CR46401,3R,5163822,5164106,284
FBgn0286883,CR46405,4,215957,216263,306
FBgn0286898,Tango1,2L,6649388,6654574,5186
FBgn0286914,lncRNA:CR46414,3L,11598012,11598821,809
FBgn0286916,lncRNA:CR46416,2L,20477264,20477586,322
FBgn0286928,CR46425,X,23101576,23102262,686
FBgn0286929,CG46426,2L,11842828,11843661,833
FBgn0286930,CG46427,3R,12437817,12439139,1322
FBgn0286931,CG46428,2R,17564340,17565852,1512
FBgn0286932,CG46429,2R,23713900,23733183,19283
FBgn0286939,CG46433,2R,15698726,15701696,2970
FBgn0286940,CG46434,3L,19538425,19544205,5780
FBgn0286941,CG46435,3L,19545110,19547293,2183
FBgn0286979,CG46439,3L,11093371,11096245,2874
FBgn0286980,Iyd,3L,11093371,11096245,2874
FBgn0287182,l(3)80Fj,3L,27967244,28012599,45355
FBgn0287183,l(3)80Fg,3L,25798441,26014112,215671
FBgn0287184,FASN3,3L,25752859,25762779,9920
FBgn0287185,nvd,3L,24324866,24401655,76789
FBgn0287186,scro,3L,24724162,24758036,33874
FBgn0287187,mRpS5,3L,24537236,24543534,6298
FBgn0287204,Cog8,2L,11496804,11498948,2144
FBgn0287209,Gfat1,3R,4126442,4137882,11440
FBgn0287210,CG46440,X,15854857,15857823,2966
FBgn0287215,lncRNA:CR46445,2R,20064280,20065437,1157
FBgn0287216,lncRNA:CR46446,2R,20066483,20067395,912
FBgn0287218,CG46448,2L,2391660,2392105,445
FBgn0287225,bor,3R,16261355,16264115,2760
FBgn0287234,slf,2L,4796600,4801923,5323
FBgn0287423,Nplp2,3L,13356376,13357223,847
FBgn0287454,Pa1,X,11359236,11360929,1693
FBgn0287461,lncRNA:CR46450,2L,23176238,23177906,1668
FBgn0287462,lncRNA:CR46451,3L,9036594,9040929,4335
FBgn0287463,asRNA:CR46452,3R,27929662,27931376,1714
FBgn0287464,asRNA:CR46453,2R,9971397,9972752,1355
FBgn0287478,Camta,2R,9446046,9480076,34030
FBgn0287585,Pss,3L,20522440,20526174,3734
FBgn0287586,CG46456,3L,5343619,5355346,11727
FBgn0287588,CG46458,3R,6896253,6958370,62117
FBgn0287589,CG46459,3R,10696647,10698976,2329
FBgn0287590,CG46460,3L,4224710,4227302,2592
FBgn0287592,CG46462,3L,19931691,19932331,640
FBgn0287594,CG46463,3L,3461315,3466314,4999
FBgn0287595,CG46464,X,17422320,17443994,21674
FBgn0287597,CG46466,4,661009,663124,2115
FBgn0287598,CG46467,3R,9874681,9988876,114195
FBgn0287599,CG46468,2L,9548258,9565438,17180
FBgn0287601,asRNA:CR46470,3R,15921025,15921834,809
FBgn0287603,lncRNA:CR46472,X,21520175,21527105,6930
FBgn0287604,asRNA:CR46473,X,14243302,14259236,15934
FBgn0287605,lncRNA:CR46474,3R,25140294,25156085,15791
FBgn0287606,lncRNA:CR46475,3L,23266134,23279170,13036
FBgn0287608,lncRNA:CR46477,2R,4802420,4815130,12710
FBgn0287609,lncRNA:CR46478,2R,4788763,4801505,12742
FBgn0287610,asRNA:CR46479,2L,13241409,13242021,612
FBgn0287612,lncRNA:CR46481,2R,2862767,2866470,3703
FBgn0287613,lncRNA:CR46482,3L,27821333,27881412,60079
FBgn0287614,lncRNA:CR46483,3L,24957239,24975495,18256
FBgn0287615,asRNA:CR46484,3L,20785216,20789624,4408
FBgn0287616,asRNA:CR46485,2R,18853372,18861263,7891
FBgn0287619,lncRNA:CR46488,4,180529,182098,1569
FBgn0287620,lncRNA:CR46489,2R,3481473,3483439,1966
FBgn0287630,dbf,2L,10651613,10654499,2886
FBgn0287631,CG46491,2R,17100241,17107542,7301
FBgn0287632,CG46492,2R,17104321,17105578,1257
FBgn0287633,lncRNA:Vinr,X,12749894,12752350,2456
FBgn0287645,ccb,X,21193253,21194521,1268
FBgn0287668,lncRNA:CR46495,2L,3495334,3496000,666
FBgn0287695,KFase,2L,6487342,6488756,1414
FBgn0287696,mus302,3L,16776531,16779736,3205
FBgn0287720,Pen,2L,10056900,10060095,3195
FBgn0287724,Ca-beta,2L,11156118,11203544,47426
FBgn0287725,sov,X,6756322,6770712,14390
FBgn0287767,Cndp2,2R,5697872,5700212,2340
FBgn0287768,esg,2L,15333866,15336138,2272
FBgn0287774,CG9143,2R,20275973,20278915,2942
FBgn0287775,18w,2R,20111511,20116932,5421
FBgn0287788,Datp,2L,9938178,9938790,612
FBgn0287825,Vha44,2R,16324813,16336637,11824
FBgn0287828,Pkcdelta,X,12432224,12453650,21426
FBgn0287831,speck,2R,24139563,24157762,18199
FBgn0287844,Dhc1,3R,9651179,9674643,23464
FBgn0287864,hbs,2R,15011396,15042134,30738
FBgn0287873,zip,2R,24990570,25011965,21395
FBgn0288229,CG3164,2L,122624,130791,8167
FBgn0288232,Cyp6a21,2R,14885264,14886947,1683
FBgn0288310,mv,3L,1950306,1964178,13872
FBgn0288433,L,2R,14435899,14465881,29982
FBgn0288447,BaraA2,2R,13407011,13408358,1347
FBgn0288469,Pex23,3L,20297129,20302141,5012
FBgn0288470,Cpsf5,3L,9411038,9413835,2797
FBgn0288631,Yif1,3R,26717871,26719806,1935
FBgn0288686,betaTub60D,2R,24305881,24313099,7218
FBgn0288690,Dna2,X,10010481,10014279,3798
FBgn0288700,stg1,X,21093844,21111417,17573
FBgn0288701,lncRNA:CR46499,X,4373271,4383220,9949
FBgn0288748,CG46523,3L,1933633,1939103,5470
FBgn0288810,CG46525,3L,17475220,17475429,209
FBgn0288833,RPA3,X,11615097,11615840,743
FBgn0288834,RPA2,2L,20924975,20926147,1172
FBgn0288846,unc-45,3R,8033301,8037403,4102
FBgn0288856,peo,2R,9864510,9875072,10562
FBgn0288857,Ype,X,13385914,13387417,1503
FBgn0288875,Cul5,3R,29059272,29062975,3703
FBgn0288888,tx,3R,26440778,26448991,8213
FBgn0288966,Med,3R,31611046,31615375,4329
FBgn0288967,CG10793,X,3314744,3316402,1658
FBgn0288976,Dnaaf5,3R,14358356,14361786,3430
FBgn0289108,Archease,3R,21661186,21662972,1786
FBgn0289122,Ino80,3R,19368995,19403153,34158
FBgn0289323,IntS8,2R,16850437,16854104,3667
FBgn0289438,lncRNA:CR46529,2L,9747046,9747785,739
FBgn0289440,lncRNA:CR46531,3R,14099143,14099715,572
FBgn0289444,lncRNA:CR46535,2L,7595504,7597500,1996
FBgn0289556,blo,2R,8735810,8759590,23780
FBgn0289578,CG4199,X,2066435,2073483,7048
FBgn0289579,Dld,3L,17846916,17849601,2685
FBgn0289650,jbug,2R,22717321,22740459,23138
FBgn0003295,ru,3L,1370628,1387437,16809
FBgn0035217,FucTD,3L,1416231,1417933,1702
FBgn0004635,rho,3L,1463811,1468944,5133
FBgn0028567,robl62A,3L,1477619,1478369,750
FBgn0035227,Iml1,3L,1523414,1534034,10620
FBgn0011204,cue,3L,1503226,1517271,14045
FBgn0028577,hfp,3L,1496853,1502590,5737
FBgn0043458,CG12084,3L,1490951,1496643,5692
FBgn0020248,stet,3L,1475438,1489547,14109
FBgn0035218,CG9173,3L,1421199,1423471,2272
FBgn0035213,indra,3L,1339460,1342403,2943
FBgn0035211,CG2211,3L,1333239,1335359,2120
FBgn0035210,msd5,3L,1332307,1333146,839
FBgn0035208,CG9184,3L,1321792,1322806,1014
FBgn0035206,sturkopf,3L,1311719,1313377,1658
FBgn0035204,Nt5a,3L,1304850,1307418,2568
FBgn0010333,Rac1,3L,1300879,1302683,1804
FBgn0035194,Psf1,3L,1246986,1247677,691
FBgn0052318,CG32318,3L,1246073,1246923,850
FBgn0004378,Klp61F,3L,1241568,1245910,4342
FBgn0035193,CG9192,3L,1237133,1238319,1186
FBgn0035229,pns,3L,1537137,1544823,7686
FBgn0041342,Pcyt1,3L,1546092,1553504,7412
FBgn0035231,Pcyt2,3L,1553493,1555315,1822
FBgn0035233,Pex10,3L,1558228,1559863,1635
FBgn0035236,Tmep,3L,1569181,1576330,7149
FBgn0035237,CG13917,3L,1576699,1600845,24146
FBgn0035244,ABCB7,3L,1618414,1623413,4999
FBgn0053230,CG33230,3L,1618414,1620397,1983
FBgn0013753,Bgb,3L,1639711,1640952,1241
FBgn0035248,CG13919,3L,1645467,1645983,516
FBgn0025712,CG13920,3L,1648944,1651501,2557
FBgn0035252,CG7970,3L,1652750,1654238,1488
FBgn0035254,CG7974,3L,1665138,1666594,1456
FBgn0035257,CG12011,3L,1694617,1696412,1795
FBgn0035260,CG7991,3L,1674709,1715541,40832
FBgn0035266,Gk2,3L,1738407,1745421,7014
FBgn0035267,CG13921,3L,1746907,1752390,5483
FBgn0035268,CG8001,3L,1756159,1759208,3049
FBgn0027903,PolD2,3L,1775633,1777019,1386
FBgn0035272,mRpL46,3L,1777439,1778347,908
FBgn0011573,Cdc37,3L,1795392,1797307,1915
FBgn0035273,CG12020,3L,1797305,1798610,1305
FBgn0067864,Patj,3L,1798803,1802184,3381
FBgn0027790,GV1,3L,1810588,1822903,12315
FBgn0035280,Cpr62Bb,3L,1832636,1835164,2528
FBgn0035279,Cpr62Ba,3L,1824129,1831783,7654
FBgn0025820,JTBR,3L,1802008,1802856,848
FBgn0024510,dlt,3L,1789631,1795328,5697
FBgn0035271,CG2021,3L,1777010,1777411,401
FBgn0035270,CG13933,3L,1771809,1775147,3338
FBgn0013811,Dhc62B,3L,1759172,1771758,12586
FBgn0022702,Cht2,3L,1752328,1755934,3606
FBgn0035264,Oseg4,3L,1730993,1735767,4774
FBgn0027594,drpr,3L,1715595,1731107,15512
FBgn0035262,CG18171,3L,1720616,1723153,2537
FBgn0035256,CG13930,3L,1670407,1672727,2320
FBgn0035255,RabX5,3L,1668901,1670108,1207
FBgn0026372,RpL23A,3L,1666288,1668654,2366
FBgn0035251,Vta1,3L,1651432,1652900,1468
FBgn0035249,CG17249,3L,1645931,1647464,1533
FBgn0025725,alphaCOP,3L,1641066,1645199,4133
FBgn0035247,Mettl2,3L,1637942,1639235,1293
FBgn0013342,nSyb,3L,1630348,1637752,7404
FBgn0035245,GC,3L,1623179,1629301,6122
FBgn0035246,CG13928,3L,1625791,1628377,2586
FBgn0035243,CG13926,3L,1617348,1618158,810
FBgn0035241,CG12105,3L,1610696,1615801,5105
FBgn0035238,CG12104,3L,1600726,1602674,1948
FBgn0035235,CG7879,3L,1559813,1568608,8795
FBgn0035232,CG12099,3L,1555363,1558484,3121
FBgn0052313,CG32313,3L,1544828,1545743,915
FBgn0035228,CG12091,3L,1534929,1536835,1906
FBgn0035283,CG12024,3L,1857165,1859047,1882
FBgn0035285,CG12025,3L,1865430,1869491,4061
FBgn0035286,CG13924,3L,1870019,1871564,1545
FBgn0035294,Mfap1,3L,1941068,1942872,1804
FBgn0035295,Cnb,3L,1947565,1950262,2697
FBgn0035298,SCOT,3L,1963143,1966805,3662
FBgn0035300,acs,3L,1971638,1974285,2647
FBgn0027547,CG1927,3L,1966725,1970079,3354
FBgn0002872,mu2,3L,1942734,1947475,4741
FBgn0035293,CG5687,3L,1933633,1939103,5470
FBgn0035290,dsb,3L,1893408,1910197,16789
FBgn0035287,CG13937,3L,1876551,1883041,6490
FBgn0042712,HBS1,3L,1862881,1865240,2359
FBgn0004636,Rap1,3L,1859115,1862239,3124
FBgn0035282,CNMa,3L,1850915,1855591,4676
FBgn0035281,Cpr62Bc,3L,1840281,1842084,1803
FBgn0035317,Oseg2,3L,2229646,2235253,5607
FBgn0040507,ACXD,3L,2237608,2243719,6111
FBgn0015359,Elp5,3L,2257456,2258922,1466
FBgn0035323,CG13807,3L,2262919,2263615,696
FBgn0035334,CG8993,3L,2372199,2372876,677
FBgn0035336,CG9004,3L,2373728,2376488,2760
FBgn0035337,CG15877,3L,2376484,2377556,1072
FBgn0035335,mRpL23,3L,2372844,2373704,860
FBgn0035333,CG1317,3L,2367843,2371939,4096
FBgn0041709,yellow-g,3L,2269881,2272769,2888
FBgn0000543,ecd,3L,2263581,2265857,2276
FBgn0015360,oxt,3L,2258839,2262664,3825
FBgn0035321,CG1275,3L,2252744,2257423,4679
FBgn0035318,CG9018,3L,2235284,2237076,1792
FBgn0035316,CG15878,3L,2210873,2212503,1630
FBgn0026593,CG5707,3L,2189160,2192221,3061
FBgn0035312,CG15820,3L,2172995,2174332,1337
FBgn0026570,CG5704,3L,2169553,2170971,1418
FBgn0035309,CG15879,3L,2167550,2169108,1558
FBgn0035308,CG15822,3L,2153201,2163863,10662
FBgn0035346,CG1146,3L,2488804,2492613,3809
FBgn0016794,dos,3L,2589414,2595590,6176
FBgn0062517,CG16984,3L,2595781,2596998,1217
FBgn0035355,CG16985,3L,2599297,2600242,945
FBgn0035356,CG16986,3L,2600331,2601536,1205
FBgn0035357,MEP-1,3L,2631715,2641984,10269
FBgn0035359,CG1143,3L,2645368,2647192,1824
FBgn0035360,CG1246,3L,2648048,2650205,2157
FBgn0053233,CG33233,3L,2659639,2661501,1862
FBgn0053234,CG33234,3L,2661622,2663622,2000
FBgn0052296,Mrtf,3L,2717615,2766536,48921
FBgn0027082,ProRS-m,3L,2650161,2651850,1689
FBgn0035358,CG14949,3L,2642184,2643424,1240
FBgn0011828,Pxn,3L,2601455,2630064,28609
FBgn0028504,CG12182,3L,2595842,2599579,3737
FBgn0010909,msn,3L,2554847,2586540,31693
FBgn0010905,Spn,3L,2505245,2554292,49047
FBgn0260480,CG32295,3L,2525799,2526973,1174
FBgn0035348,CG16758,3L,2499372,2503606,4234
FBgn0035344,Cyp4d20,3L,2476259,2478448,2189
FBgn0035343,CG16762,3L,2474667,2475614,947
FBgn0035370,Non2,3L,2766999,2768392,1393
FBgn0044452,Atg2,3L,2774338,2780677,6339
FBgn0035374,mRpS35,3L,2780899,2782105,1206
FBgn0035375,Pgant6,3L,2782255,2786010,3755
FBgn0035382,Or63a,3L,2961534,2963788,2254
FBgn0035383,CPT2,3L,2981022,2983551,2529
FBgn0035384,CG2113,3L,2995172,2996155,983
FBgn0035385,FMRFaR,3L,3001716,3011860,10144
FBgn0035388,CG2162,3L,3035196,3040469,5273
FBgn0040308,Prx4,3L,3042359,3044174,1815
FBgn0052485,CG32485,3L,3050323,3051765,1442
FBgn0035392,CG1271,3L,3052514,3054906,2392
FBgn0035393,CG16753,3L,3055079,3055842,763
FBgn0035397,PAN3,3L,3071133,3090406,19273
FBgn0035390,scramb2,3L,3044113,3046812,2699
FBgn0035380,CG9970,3L,2915024,2916654,1630
FBgn0035379,spz5,3L,2883641,2892166,8525
FBgn0035372,CG12093,3L,2772560,2774007,1447
FBgn0035371,AhcyL1,3L,2768466,2772325,3859
FBgn0035401,Alg2,3L,3143808,3145284,1476
FBgn0035405,CG15812,3L,3159991,3162019,2028
FBgn0024194,rasp,3L,3162180,3163852,1672
FBgn0052280,CG32280,3L,3165181,3169080,3899
FBgn0052278,CG32278,3L,3169286,3171767,2481
FBgn0052281,CG32281,3L,3169375,3170913,1538
FBgn0052284,CG32284,3L,3186664,3187245,581
FBgn0001233,Hsp83,3L,3192969,3197059,4090
FBgn0035421,nSMase,3L,3219156,3220925,1769
FBgn0035423,eIF1,3L,3223341,3224650,1309
FBgn0035424,Larp4B,3L,3224838,3236604,11766
FBgn0035427,ckd,3L,3257878,3268184,10306
FBgn0035432,ZnT63C,3L,3303708,3314009,10301
FBgn0052279,Drsl2,3L,3314349,3314681,332
FBgn0052282,Drsl4,3L,3315620,3315942,322
FBgn0035434,Drsl5,3L,3316781,3317144,363
FBgn0035436,CG12016,3L,3319555,3322489,2934
FBgn0035438,Gtpx,3L,3326265,3328626,2361
FBgn0035439,CG14961,3L,3330063,3333181,3118
FBgn0004167,kst,3L,3336860,3368133,31273
FBgn0035443,CG12010,3L,3374282,3376649,2367
FBgn0035444,CG12012,3L,3376757,3377992,1235
FBgn0035445,Ids,3L,3378268,3380083,1815
FBgn0027616,Ythdc1,3L,3370451,3374170,3719
FBgn0035440,CG14969,3L,3333119,3334978,1859
FBgn0035437,Strip,3L,3322025,3328871,6846
FBgn0035435,PIG-C,3L,3318028,3319232,1204
FBgn0035431,CG14968,3L,3299336,3303112,3776
FBgn0035425,CG17746,3L,3236805,3239578,2773
FBgn0035422,RpL28,3L,3220911,3222960,2049
FBgn0035420,hob,3L,3210992,3218920,7928
FBgn0052271,CG32271,3L,3202238,3203162,924
FBgn0047135,CG32276,3L,3197863,3199047,1184
FBgn0035415,CG14966,3L,3197045,3197631,586
FBgn0035414,CG14965,3L,3190622,3192491,1869
FBgn0035410,MnM,3L,3172817,3178580,5763
FBgn0035409,CG14963,3L,3171614,3172545,931
FBgn0035407,Asciz,3L,3163786,3166250,2464
FBgn0035402,Usp5,3L,3145405,3148358,2953
FBgn0035400,CG11537,3L,3128034,3143457,15423
FBgn0026189,promL,3L,3114450,3127724,13274
FBgn0035398,Cht7,3L,3090985,3106958,15973
FBgn0005640,Eip63E,3L,3515751,3610521,94770
FBgn0035452,CG10359,3L,3612192,3615244,3052
FBgn0035453,CG10357,3L,3615382,3616682,1300
FBgn0035455,CG10862,3L,3653405,3654771,1366
FBgn0001254,ImpE2,3L,3510974,3512681,1707
FBgn0052267,CG32267,3L,3471555,3472113,558
FBgn0035449,CG14971,3L,3468023,3471309,3286
FBgn0026259,eIF5B,3L,3428658,3460977,32319
FBgn0014388,sty,3L,3401153,3424935,23782
FBgn0035462,IntS10,3L,3806710,3809090,2380
FBgn0035464,PIG-B,3L,3811263,3813958,2695
FBgn0004888,Scsalpha1,3L,3814211,3818383,4172
FBgn0004875,enc,3L,3818679,3842326,23647
FBgn0064227,Rdh,3L,3825449,3828525,3076
FBgn0013751,Awh,3L,3846206,3861692,15486
FBgn0026592,Fie,3L,3892574,3894833,2259
FBgn0035469,Lamtor4,3L,3896900,3897498,598
FBgn0035471,Sc2,3L,3903492,3905035,1543
FBgn0041147,ida,3L,3905344,3907813,2469
FBgn0004910,Eip63F-1,3L,3909973,3935617,25644
FBgn0035473,mge,3L,3907852,3909931,2079
FBgn0035470,Ccz1,3L,3897444,3899156,1712
FBgn0035468,Gr63a,3L,3894999,3896603,1604
FBgn0015585,Acp63F,3L,3815839,3816354,515
FBgn0052262,CG32262,3L,3809146,3810196,1050
FBgn0035461,ntc,3L,3803832,3806459,2627
FBgn0052264,CG32264,3L,3714826,3806459,91633
FBgn0035458,ppk27,3L,3753693,3755201,1508
FBgn0035490,CG1136,3L,4046596,4059660,13064
FBgn0042179,Ugt305A1,3L,4059770,4061923,2153
FBgn0000449,dib,3L,4062292,4064551,2259
FBgn0052259,CG32259,3L,4069369,4070281,912
FBgn0035495,CG14989,3L,4087581,4092706,5125
FBgn0035496,CG14990,3L,4093207,4094344,1137
FBgn0035498,Fit1,3L,4103564,4107116,3552
FBgn0028484,Ack,3L,4108186,4114157,5971
FBgn0003206,Ras64B,3L,4139076,4141398,2322
FBgn0004552,Akh,3L,4141467,4142070,603
FBgn0052260,CG32260,3L,4142364,4145966,3602
FBgn0035501,CG1299,3L,4148696,4152473,3777
FBgn0040696,CG18675,3L,4173884,4192968,19084
FBgn0003710,tipE,3L,4188499,4193788,5289
FBgn0035513,Cpr64Ad,3L,4215379,4216414,1035
FBgn0035515,Sqor,3L,4240173,4242603,2430
FBgn0011692,pav,3L,4242734,4246233,3499
FBgn0035517,CG1265,3L,4254776,4256053,1277
FBgn0035519,CG1309,3L,4259430,4261643,2213
FBgn0035521,VhaM9.7-a,3L,4262705,4263464,759
FBgn0035522,CG1273,3L,4263719,4277778,14059
FBgn0035523,Ctl1,3L,4277962,4281585,3623
FBgn0035526,CG1316,3L,4283851,4286865,3014
FBgn0015829,TfIIEbeta,3L,4287038,4288349,1311
FBgn0041630,Hexo1,3L,4288641,4291211,2570
FBgn0035529,Fdx2,3L,4292482,4293432,950
FBgn0035528,CG15012,3L,4291208,4292246,1038
FBgn0035524,CG11583,3L,4281504,4282817,1313
FBgn0035520,CG11586,3L,4261297,4262470,1173
FBgn0035518,CG15011,3L,4255991,4259152,3161
FBgn0041171,ago,3L,4246343,4254306,7963
FBgn0001257,ImpL2,3L,4224006,4236147,12141
FBgn0052252,asRNA:CR32252,3L,4221704,4222734,1030
FBgn0035512,Cpr64Ac,3L,4211964,4212915,951
FBgn0035510,Cpr64Aa,3L,4207838,4209178,1340
FBgn0028664,VhaM9.7-c,3L,4186018,4186865,847
FBgn0040697,Teh3,3L,4182645,4184663,2018
FBgn0035505,Teh2,3L,4178980,4188023,9043
FBgn0035504,Teh4,3L,4174859,4178270,3411
FBgn0004574,Rop,3L,4136359,4138996,2637
FBgn0035499,Chd64,3L,4114289,4122388,8099
FBgn0004516,Gad1,3L,4074077,4088744,14667
FBgn0016013,Faa,3L,4072032,4073954,1922
FBgn0024179,wit,3L,4064152,4071717,7565
FBgn0035491,Dpy-30L2,3L,4046988,4047735,747
FBgn0035488,CG11593,3L,4037523,4040482,2959
FBgn0052251,Claspin,3L,4313483,4318608,5125
FBgn0052250,PMP34,3L,4318755,4321109,2354
FBgn0035534,mRpS6,3L,4364550,4365243,693
FBgn0035539,slow,3L,4384442,4403181,18739
FBgn0035540,Syx17,3L,4403487,4405168,1681
FBgn0035542,TP53INP,3L,4406943,4420648,13705
FBgn0035543,CG15020,3L,4421662,4426621,4959
FBgn0000038,nAChRbeta1,3L,4429349,4435993,6644
FBgn0035544,CG15021,3L,4436721,4438311,1590
FBgn0035550,CG11349,3L,4473068,4475095,2027
FBgn0035557,CG11353,3L,4533170,4539270,6100
FBgn0035558,CG11357,3L,4542051,4553457,11406
FBgn0015805,HDAC1,3L,4626734,4629467,2733
FBgn0035563,CG13716,3L,4634436,4634789,353
FBgn0052243,CG32243,3L,4539302,4541244,1942
FBgn0014073,Tie,3L,4510698,4532145,21447
FBgn0035553,CG13722,3L,4485159,4490963,5804
FBgn0052241,CG32241,3L,4465105,4466630,1525
FBgn0035541,CG15019,3L,4405127,4406059,932
FBgn0052240,CG32240,3L,4380864,4381629,765
FBgn0035538,DopEcR,3L,4367649,4380387,12738
FBgn0035537,CG11342,3L,4366494,4367458,964
FBgn0035533,Cip4,3L,4322491,4364102,41611
FBgn0035532,CG15014,3L,4321105,4322259,1154
FBgn0066365,dyl,3L,4294004,4307718,13714
FBgn0052238,TTLL1B,3L,4648276,4650305,2029
FBgn0035574,RhoGEF64C,3L,4692783,4796253,103470
FBgn0027085,LeuRS-m,3L,4825853,4829038,3185
FBgn0035581,Dnah3,3L,4861269,4895749,34480
FBgn0035583,hoka,3L,4898900,4900869,1969
FBgn0028699,Rh50,3L,4910368,4920198,9830
FBgn0035578,CG13707,3L,4837791,4840108,2317
FBgn0035577,CG13708,3L,4829092,4833591,4499
FBgn0042131,CG18808,3L,4806053,4807406,1353
FBgn0035575,CG7509,3L,4803077,4805274,2197
FBgn0035571,CG12493,3L,4752393,4753738,1345
FBgn0035568,CG18418,3L,4688929,4690070,1141
FBgn0046793,CG32236,3L,4665927,4667389,1462
FBgn0035585,ATPsynCF6L,3L,5011444,5012133,689
FBgn0052232,t-Grip128,3L,4993950,4996877,2927
FBgn0035584,CG17030,3L,4980003,4980769,766
FBgn0005775,Con,3L,4936758,5079033,142275
FBgn0030234,CG15211,X,10772541,10778981,6440
FBgn0040850,CG15210,X,10839230,10839895,665
FBgn0030237,CG15209,X,10842205,10842995,790
FBgn0030239,Pgls,X,10847438,10848534,1096
FBgn0030240,CG2202,X,10848757,10852327,3570
FBgn0030243,CG2186,X,10857655,10866246,8591
FBgn0030244,CG2157,X,10869284,10870705,1421
FBgn0030247,CG15208,X,10899965,10901811,1846
FBgn0003965,v,X,10923972,10925631,1659
FBgn0030251,Arlr,X,10927399,10929712,2313
FBgn0030257,SmydA-4,X,11044756,11049540,4784
FBgn0030261,CG15203,X,11066552,11068379,1827
FBgn0030260,CG1537,X,11062027,11063170,1143
FBgn0030259,CG1545,X,11057545,11059619,2074
FBgn0030258,CG1552,X,11052171,11053556,1385
FBgn0021742,C901,X,10964032,10967134,3102
FBgn0030246,CG1582,X,10894747,10899302,4555
FBgn0017561,Ork1,X,10878054,10891250,13196
FBgn0030245,CG1637,X,10870594,10877893,7299
FBgn0030242,sofe,X,10855000,10857413,2413
FBgn0030241,feo,X,10852446,10854869,2423
FBgn0003321,sbr,X,10832752,10847092,14340
FBgn0052669,CG32669,X,10842697,10845081,2384
FBgn0003360,sesB,X,10780893,10786958,6065
FBgn0025111,Ant2,X,10778954,10786907,7953
FBgn0030263,CG2076,X,11090210,11092098,1888
FBgn0027498,CG2061,X,11092492,11094947,2455
FBgn0015245,Hsp60A,X,11108482,11112308,3826
FBgn0028686,Rpt3,X,11125101,11126785,1684
FBgn0030269,CDK2AP1,X,11137859,11139689,1830
FBgn0030271,CG15202,X,11142541,11143755,1214
FBgn0030272,CG15201,X,11144120,11144809,689
FBgn0030274,Lint-1,X,11149323,11152592,3269
FBgn0030276,Dlic,X,11154421,11164670,10249
FBgn0030278,CG15200,X,11182931,11183476,545
FBgn0030280,CG11106,X,11202248,11202806,558
FBgn0030283,CG15198,X,11248236,11248885,649
FBgn0030286,Gapvd1,X,11325385,11334071,8686
FBgn0030291,CG1738,X,11349049,11349847,798
FBgn0030292,NdufV3,X,11349998,11350474,476
FBgn0030293,CG1737,X,11350608,11355539,4931
FBgn0000499,dsh,X,11355881,11358724,2843
FBgn0004864,hop,X,11360930,11368098,7168
FBgn0030289,GCS1,X,11344506,11348001,3495
FBgn0028421,Kap3,X,11334187,11340084,5897
FBgn0001491,l(1)10Bb,X,11324294,11325308,1014
FBgn0030277,CG1394,X,11169811,11170678,867
FBgn0026268,Antdh,X,11168030,11169058,1028
FBgn0052668,CG32668,X,11156676,11159760,3084
FBgn0020255,Ran,X,11144852,11148716,3864
FBgn0030270,CG15199,X,11140474,11141835,1361
FBgn0052667,ssp7,X,11139762,11140263,501
FBgn0030268,Klp10A,X,11129362,11137118,7756
FBgn0010391,SrpRalpha,X,11126877,11129087,2210
FBgn0030266,CG11122,X,11112395,11124726,12331
FBgn0027359,Tim8,X,11368445,11369283,838
FBgn0030296,CG15196,X,11409947,11411667,1720
FBgn0001145,Gs2,X,11422832,11430197,7365
FBgn0030300,Sk1,X,11442539,11446012,3473
FBgn0030301,HP5,X,11454786,11459227,4441
FBgn0030304,Cyp4g15,X,11477058,11483233,6175
FBgn0030305,Uba5,X,11483518,11485060,1542
FBgn0030306,Spase25,X,11485250,11486566,1316
FBgn0052666,Drak,X,11493135,11555045,61910
FBgn0030310,PGRP-SA,X,11561643,11562779,1136
FBgn0030311,CG11699,X,11570621,11571718,1097
FBgn0030314,CG11696,X,11573731,11576152,2421
FBgn0030316,CG11695,X,11576883,11578806,1923
FBgn0019660,lncRNA:roX2,X,11579065,11580432,1367
FBgn0002948,nod,X,11580772,11585750,4978
FBgn0030318,rho-4,X,11599838,11606288,6450
FBgn0030321,CG1703,X,11611927,11615128,3201
FBgn0002723,Met,X,11616124,11621280,5156
FBgn0004370,Ptp10D,X,11622015,11677338,55323
FBgn0014133,bif,X,11678970,11694740,15770
FBgn0030326,CG2444,X,11704310,11705300,990
FBgn0030323,Vlet,X,11677344,11678589,1245
FBgn0030320,CG2247,X,11606290,11611652,5362
FBgn0030319,CG2533,X,11603243,11604194,951
FBgn0030317,pkm,X,11581957,11584175,2218
FBgn0000618,e(y)2,X,11576118,11576620,502
FBgn0027259,Kmn1,X,11571383,11572442,1059
FBgn0003277,Polr2A,X,11562800,11570326,7526
FBgn0030309,CG1572,X,11555050,11558654,3604
FBgn0030307,CG33235,X,11486546,11491573,5027
FBgn0030298,Or10a,X,11413467,11417422,3955
FBgn0045502,Gr10a,X,11413467,11417422,3955
FBgn0030297,Gr10b,X,11411783,11413190,1407
FBgn0030329,prtp,X,11716756,11719894,3138
FBgn0030330,Tango10,X,11720245,11723854,3609
FBgn0030331,CG15221,X,11724246,11736617,12371
FBgn0002577,m,X,11754273,11769508,15235
FBgn0030334,Karl,X,11787381,11792253,4872
FBgn0030339,Cyp28c1,X,11839608,11841503,1895
FBgn0030343,ATP7,X,11855022,11864754,9732
FBgn0030345,CG1847,X,11869170,11871168,1998
FBgn0030347,CG15739,X,11873319,11875346,2027
FBgn0030350,SelG,X,11887284,11888240,956
FBgn0030351,CG1840,X,11888352,11889186,834
FBgn0030352,sicily,X,11891732,11893745,2013
FBgn0030360,CG1806,X,12007176,12009904,2728
FBgn0030362,regucalcin,X,12012377,12017375,4998
FBgn0030361,CG1492,X,12009711,12012211,2500
FBgn0001083,fw,X,11992915,12003914,10999
FBgn0030359,CG18130,X,11990118,11992768,2650
FBgn0000808,gd,X,11985154,11987764,2610
FBgn0030358,Pdzd8,X,11926424,11930850,4426
FBgn0030357,Sclp,X,11920004,11924662,4658
FBgn0030356,lncRNA:CR32661,X,11917806,11918678,872
FBgn0030354,Upf1,X,11899996,11905371,5375
FBgn0030349,CG10353,X,11877737,11887162,9425
FBgn0030348,CG10352,X,11875306,11877168,1862
FBgn0030346,BORCS5,X,11871299,11872779,1480
FBgn0030344,Nrd1,X,11864651,11868893,4242
FBgn0030342,CG10347,X,11852692,11854931,2239
FBgn0030341,p24-1,X,11850909,11852530,1621
FBgn0001218,Hsc70-3,X,11801696,11807117,5421
FBgn0004511,dy,X,11769769,11778784,9015
FBgn0030332,CG9360,X,11763474,11764590,1116
FBgn0030328,Amun,X,11710120,11715565,5445
FBgn0030327,FucT6,X,11706575,11709951,3376
FBgn0030364,Lsm12a,X,12018640,12020719,2079
FBgn0030365,Tango4,X,12021068,12022746,1678
FBgn0030369,Cyp318a1,X,12032632,12035283,2651
FBgn0052657,lncRNA:CR32657,X,12087211,12087695,484
FBgn0040859,lncRNA:CR32658,X,12091264,12092272,1008
FBgn0030376,CG2750,X,12107200,12113357,6157
FBgn0052655,CG32655,X,12234562,12235877,1315
FBgn0030373,moon,X,12072008,12072818,810
FBgn0030367,Cyp311a1,X,12029754,12031465,1711
FBgn0030366,Usp7,X,12022837,12029032,6195
FBgn0043001,Chrac-16,X,12017225,12017961,736
FBgn0030389,CG15927,X,12454729,12455683,954
FBgn0030394,Cpr11A,X,12486970,12489448,2478
FBgn0002562,Lsp1alpha,X,12490291,12492982,2691
FBgn0030396,mdu,X,12497188,12516565,19377
FBgn0030398,Cpr11B,X,12553124,12554235,1111
FBgn0052654,Sec16,X,12596047,12609910,13863
FBgn0030407,Fpgs1,X,12611867,12615530,3663
FBgn0030408,CG11085,X,12616316,12621216,4900
FBgn0030406,CG1463,X,12609977,12611667,1690
FBgn0030403,CG1824,X,12592555,12595624,3069
FBgn0030400,Pits,X,12569169,12583193,14024
FBgn0030395,Mks1,X,12494395,12496597,2202
FBgn0030391,Rab40,X,12459796,12463112,3316
FBgn0052651,CG32651,X,12404616,12408477,3861
FBgn0030385,Ir11a,X,12375596,12377755,2159
FBgn0030409,CG15728,X,12624292,12628445,4153
FBgn0030411,CG2540,X,12629878,12631111,1233
FBgn0030412,Tomosyn,X,12631605,12653442,21837
FBgn0015024,CkIalpha,X,12653626,12657834,4208
FBgn0030417,CG15725,X,12705854,12708841,2987
FBgn0030418,CG4004,X,12744212,12749785,5573
FBgn0030421,Agpat1,X,12765266,12772851,7585
FBgn0030425,Nep6,X,12801661,12804232,2571
FBgn0030433,mRpL49,X,12907105,12907942,837
FBgn0030435,CG4645,X,12909953,12912070,2117
FBgn0030434,Brms1,X,12907986,12909622,1636
FBgn0030432,CG4404,X,12903745,12906018,2273
FBgn0030431,Flad1,X,12901353,12903516,2163
FBgn0052649,Coq8,X,12898768,12901114,2346
FBgn0052650,CG32650,X,12897503,12898669,1166
FBgn0030429,CG4661,X,12855688,12857722,2034
FBgn0052647,CG32647,X,12771844,12784958,13114
FBgn0030420,pira,X,12760642,12763611,2969
FBgn0020513,Paics,X,12757036,12760617,3581
FBgn0030410,Aven,X,12628370,12629640,1270
FBgn0030438,CG15721,X,12970711,12973967,3256
FBgn0030447,CG2200,X,13094299,13095732,1433
FBgn0030451,CG15717,X,13128952,13134565,5613
FBgn0030452,MFS10,X,13129018,13134839,5821
FBgn0052645,CG32645,X,13139199,13153462,14263
FBgn0030456,CG4332,X,13155038,13157372,2334
FBgn0030457,CG12096,X,13159604,13162854,3250
FBgn0052640,CG32640,X,13178005,13178523,518
FBgn0052641,CG32641,X,13184478,13184996,518
FBgn0029133,REG,X,13212325,13214408,2083
FBgn0004456,mew,X,13214409,13258490,44081
FBgn0030460,Coq5,X,13193094,13194551,1457
FBgn0030459,CG12723,X,13189643,13191883,2240
FBgn0025463,Bap60,X,13157445,13159508,2063
FBgn0030455,CG4318,X,13153461,13154924,1463
FBgn0052638,CG32638,X,13122876,13128794,5918
FBgn0030449,Fer3HCH,X,13107382,13108194,812
FBgn0010303,hep,X,13079205,13090434,11229
FBgn0030439,CG12716,X,12974683,12976231,1548
FBgn0030437,hec,X,12950436,12957462,7026
FBgn0000346,comt,X,13259021,13262488,3467
FBgn0030465,CG15743,X,13285707,13287741,2034
FBgn0030466,Remo,X,13288051,13294433,6382
FBgn0030468,CG1622,X,13297082,13299910,2828
FBgn0040309,Prx2,X,13329824,13331994,2170
FBgn0052636,lncRNA:CR32636,X,13332374,13333857,1483
FBgn0030474,CG15747,X,13338318,13341009,2691
FBgn0030478,CG1640,X,13370606,13380160,9554
FBgn0030480,Tim9a,X,13385210,13385893,683
FBgn0030481,CG1662,X,13387563,13389332,1769
FBgn0030482,Bcat,X,13396899,13401224,4325
FBgn0030484,GstT4,X,13404749,13409323,4574
FBgn0030486,Set2,X,13413242,13421024,7782
FBgn0030485,CG1998,X,13409369,13413074,3705
FBgn0030479,Rbp1-like,X,13380166,13384877,4711
FBgn0010198,RpS15Aa,X,13335637,13337705,2068
FBgn0030467,CG1764,X,13294473,13302415,7942
FBgn0030499,CG11178,X,13605681,13609529,3848
FBgn0030501,BthD,X,13612131,13613228,1097
FBgn0030503,Tango2,X,13616989,13619207,2218
FBgn0030505,NFAT,X,13624745,13664568,39823
FBgn0030507,CG11164,X,13668014,13669573,1559
FBgn0030508,CG15760,X,13669699,13676232,6533
FBgn0030511,CG11158,X,13682952,13684616,1664
FBgn0002878,mus101,X,13722246,13727113,4867
FBgn0030518,CG11134,X,13737942,13739177,1235
FBgn0030519,CG11151,X,13739744,13741952,2208
FBgn0020909,Rtc1,X,13757179,13758598,1419
FBgn0030528,CG11095,X,13811684,13812870,1186
FBgn0027537,Nup93-1,X,13822826,13825910,3084
FBgn0052626,AMPdeam,X,13830741,13845866,15125
FBgn0030530,jub,X,13826041,13830317,4276
FBgn0030529,Clic,X,13812971,13822307,9336
FBgn0030525,CG10996,X,13796389,13797638,1249
FBgn0030521,CtsB,X,13779847,13782170,2323
FBgn0030520,Pdcd4,X,13745577,13755406,9829
FBgn0001612,Grip91,X,13736570,13744683,8113
FBgn0001087,g,X,13727204,13736278,9074
FBgn0030514,Mrgn1,X,13718734,13721977,3243
FBgn0030512,Nadsyn,X,13684380,13718285,33905
FBgn0030510,CG12177,X,13677899,13680500,2601
FBgn0030506,DNAlig4,X,13664584,13667811,3227
FBgn0030504,CG2691,X,13619276,13624408,5132
FBgn0030502,tth,X,13613193,13616586,3393
FBgn0030500,Ndc80,X,13609671,13612062,2391
FBgn0030536,CG11068,X,13955236,13956574,1338
FBgn0000173,ben,X,13996345,13999805,3460
FBgn0030539,CG1368,X,14174756,14175670,914
FBgn0052603,CG32603,X,14184561,14185807,1246
FBgn0030543,CG11585,X,14189516,14190755,1239
FBgn0004649,yl,X,14193214,14199958,6744
FBgn0052600,dpr8,X,14322226,14462351,140125
FBgn0030566,betaNACtes4,X,14380351,14381416,1065
FBgn0030569,CG9411,X,14472408,14480086,7678
FBgn0030570,CG12540,X,14496135,14497240,1105
FBgn0030571,CG14414,X,14580600,14582174,1574
FBgn0030573,nmdyn-D6,X,14583677,14584616,939
FBgn0030575,CG5321,X,14679568,14681418,1850
FBgn0015010,Ag5r,X,14784664,14786551,1887
FBgn0030576,CG15890,X,14757531,14765787,8256
FBgn0015774,NetB,X,14686038,14749376,63338
FBgn0030574,sbm,X,14584733,14602580,17847
FBgn0030572,mRpS25,X,14582136,14582982,846
FBgn0030582,CG14411,X,14832647,14836262,3615
FBgn0030583,CG14410,X,14836725,14837330,605
FBgn0000535,eag,X,14955477,15009989,54512
FBgn0052594,be,X,15024436,15042060,17624
FBgn0030603,CG5541,X,15044123,15051842,7719
FBgn0030605,ND-B18,X,15063733,15064926,1193
FBgn0030607,dob,X,15067007,15069091,2084
FBgn0053177,CG33177,X,15081367,15082369,1002
FBgn0053178,CG33178,X,15082827,15084017,1190
FBgn0030612,Dbct,X,15086125,15088629,2504
FBgn0030611,CG15027,X,15085159,15085827,668
FBgn0030610,Cox17,X,15084029,15084699,670
FBgn0030608,Lsd-2,X,15069127,15076220,7093
FBgn0030600,hiw,X,15010137,15063429,53292
FBgn0027601,pdgy,X,14933670,14953532,19862
FBgn0052591,CG32591,X,14927202,14928944,1742
FBgn0030595,CG14406,X,14909873,14910845,972
FBgn0030594,fiz,X,14906334,14909708,3374
FBgn0030593,CG9512,X,14901844,14905549,3705
FBgn0030592,CG9514,X,14885952,14896891,10939
FBgn0030590,CG9518,X,14862989,14871181,8192
FBgn0030589,CG9519,X,14854328,14856361,2033
FBgn0030588,CG9521,X,14851005,14853269,2264
FBgn0030587,CG9522,X,14846472,14848808,2336
FBgn0030586,CG12539,X,14842617,14844757,2140
FBgn0052590,CG32590,X,14838352,14839106,754
FBgn0030584,Grx5,X,14837471,14838198,727
FBgn0003301,rut,X,14787478,14826073,38595
FBgn0030613,Rab3-GEF,X,15089682,15113762,24080
FBgn0030620,CG5662,X,15210386,15211467,1081
FBgn0030625,CG5877,X,15293031,15297169,4138
FBgn0015926,dah,X,15328342,15331002,2660
FBgn0026428,HDAC6,X,15333310,15340360,7050
FBgn0030631,Prp5,X,15345169,15350021,4852
FBgn0030634,CG9164,X,15380371,15385441,5070
FBgn0003132,Pp1-13C,X,15359101,15361061,1960
FBgn0030630,CG12608,X,15342857,15344625,1768
FBgn0030629,CG9123,X,15340373,15342117,1744
FBgn0030628,CG9114,X,15330784,15333154,2370
FBgn0030617,CG9095,X,15139937,15163225,23288
FBgn0030616,RpL37-1,X,15137870,15139367,1497
FBgn0030615,Cyp4s3,X,15113302,15116542,3240
FBgn0014455,Ahcy,X,15450261,15453167,2906
FBgn0030638,CG11655,X,15453471,15455551,2080
FBgn0030640,CG6294,X,15462722,15466812,4090
FBgn0030645,Alg14,X,15472164,15472859,695
FBgn0030648,CG6340,X,15482374,15486612,4238
FBgn0027287,Gmap,X,15486922,15511223,24301
FBgn0030653,CG7860,X,15568993,15570369,1376
FBgn0030658,CG7872,X,15578205,15579857,1652
FBgn0030660,CG8097,X,15583159,15585249,2090
FBgn0030666,CG12708,X,15675476,15677737,2261
FBgn0030668,CG8128,X,15697494,15700034,2540
FBgn0030671,Hap40,X,15704125,15705806,1681
FBgn0030673,CG15601,X,15710647,15712309,1662
FBgn0030672,CG9281,X,15705806,15710539,4733
FBgn0030670,Pis,X,15701451,15703770,2319
FBgn0030669,CG9240,X,15700172,15701259,1087
FBgn0030667,CG15599,X,15684947,15688857,3910
FBgn0003463,sog,X,15603283,15633434,30151
FBgn0030659,CG9215,X,15580930,15582874,1944
FBgn0030655,CG9213,X,15572076,15574535,2459
FBgn0030654,CG15643,X,15570380,15572149,1769
FBgn0030642,CG15642,X,15466184,15467757,1573
FBgn0004391,shtd,X,15455544,15462441,6897
FBgn0040285,Scamp,X,15446179,15449883,3704
FBgn0030674,HUWE1,X,15712628,15731935,19307
FBgn0030675,CG8191,X,15732178,15733663,1485
FBgn0026666,MagR,X,15734270,15735780,1510
FBgn0030679,CG8206,X,15739230,15740417,1187
FBgn0027329,CCT6,X,15746648,15748971,2323
FBgn0030683,Mvd,X,15749166,15751737,2571
FBgn0030686,mRpL3,X,15761248,15762663,1415
FBgn0030687,Polr3A,X,15762956,15769514,6558
FBgn0053172,CG33172,X,15769664,15772985,3321
FBgn0030692,mRpS30,X,15786047,15788288,2241
FBgn0026374,Rhp,X,15788897,15793632,4735
FBgn0030694,CG15602,X,15799426,15800961,1535
FBgn0030696,CG8509,X,15809555,15810947,1392
FBgn0003345,sd,X,15804370,15827682,23312
FBgn0052582,lncRNA:CR32582,X,15835601,15836923,1322
FBgn0030697,CG8565,X,15837830,15841160,3330
FBgn0030699,CG8578,X,15844476,15847858,3382
FBgn0030700,CG15914,X,15853421,15854970,1549
FBgn0001105,Gbeta13F,X,15860115,15866175,6060
FBgn0001092,Gapdh2,X,15868145,15869661,1516
FBgn0030701,CG16952,X,15870183,15875607,5424
FBgn0030704,CG15916,X,15890589,15891547,958
FBgn0003392,shi,X,15892116,15906716,14600
FBgn0030706,Lrp4,X,15910870,15921013,10143
FBgn0030707,CG8916,X,15921955,15924558,2603
FBgn0030710,CG8924,X,15941077,15944449,3372
FBgn0030711,Rrp47,X,15944897,15946249,1352
FBgn0045073,Stim,X,15934495,15940451,5956
FBgn0053180,Ranbp16,X,15927185,15933867,6682
FBgn0010315,CycD,X,15906822,15909676,2854
FBgn0030703,MSBP,X,15887567,15890109,2542
FBgn0065035,AlkB,X,15858134,15859487,1353
FBgn0002914,Myb,X,15854832,15857823,2991
FBgn0026076,UBL3,X,15849731,15853175,3444
FBgn0014391,sun,X,15847859,15849258,1399
FBgn0027093,ArgRS,X,15841769,15844145,2376
FBgn0000319,Chc,X,15827986,15835490,7504
FBgn0030695,PGRP-LE,X,15801153,15803880,2727
FBgn0052581,sordd2,X,15796908,15799162,2254
FBgn0030693,sordd1,X,15793721,15796028,2307
FBgn0025809,Paf-AHalpha,X,15784009,15785583,1574
FBgn0030691,Efhc1.1,X,15780398,15783710,3312
FBgn0030685,Graf,X,15751674,15760733,9059
FBgn0030680,CG8944,X,15741343,15746231,4888
FBgn0030678,CG11679,X,15737493,15738954,1461
FBgn0011741,Arp6,X,15735774,15737120,1346
FBgn0030676,CG12379,X,15733222,15733996,774
FBgn0030731,Mfe2,X,16270951,16273815,2864
FBgn0004066,Prosalpha4,X,16276270,16277587,1317
FBgn0000536,eas,X,16278328,16285618,7290
FBgn0030733,UQCR-14,X,16286288,16286988,700
FBgn0030735,CG3632,X,16296671,16303308,6637
FBgn0027521,CG3679,X,16303870,16307377,3507
FBgn0030739,SWIP,X,16313709,16317750,4041
FBgn0052579,CG32579,X,16323286,16325768,2482
FBgn0260450,CalpC,X,16325763,16328523,2760
FBgn0003416,sl,X,16350315,16356482,6167
FBgn0005411,U2af50,X,16356696,16359039,2343
FBgn0030743,CG9921,X,16331281,16333600,2319
FBgn0030742,CG9919,X,16328437,16330759,2322
FBgn0030740,CG9917,X,16321431,16323231,1800
FBgn0004432,Cyp1,X,16317673,16320370,2697
FBgn0030738,CG9915,X,16309817,16313138,3321
FBgn0030734,ERp44,X,16293853,16297718,3865
FBgn0040207,kat80,X,16267007,16276180,9173
FBgn0030729,CG12507,X,16265242,16266537,1295
FBgn0004598,Fur2,X,16373086,16381782,8696
FBgn0030745,CG4239,X,16385278,16388702,3424
FBgn0004367,mei-41,X,16391698,16399850,8152
FBgn0030747,CG4301,X,16405509,16414651,9142
FBgn0030748,Traf-like,X,16415046,16417585,2539
FBgn0030753,rngo,X,16441433,16445367,3934
FBgn0026181,Rok,X,16624012,16637414,13402
FBgn0030752,Cdc50,X,16438680,16441296,2616
FBgn0030749,AnxB11,X,16416958,16422265,5307
FBgn0030746,CG9981,X,16399782,16405122,5340
FBgn0010416,TH1,X,16388820,16391438,2618
FBgn0030744,CG9992,X,16381954,16384908,2954
FBgn0010412,RpS19a,X,16637894,16639249,1355
FBgn0030766,mthl1,X,16640968,16650309,9341
FBgn0052573,CG32573,X,16651376,16653275,1899
FBgn0030776,CG4653,X,16704081,16705278,1197
FBgn0030780,CG13008,X,16711303,16714372,3069
FBgn0052572,CG32572,X,16721183,16726948,5765
FBgn0052574,Twdlalpha,X,16742847,16744365,1518
FBgn0030786,mRpL22,X,16783933,16785092,1159
FBgn0030788,Sap30,X,16787283,16789644,2361
FBgn0030790,CG4768,X,16792119,16797742,5623
FBgn0030792,CG4789,X,16800930,16802000,1070
FBgn0030794,CG13005,X,16803650,16805754,2104
FBgn0030795,ppk28,X,16806068,16808515,2447
FBgn0030796,CG4829,X,16811699,16826494,14795
FBgn0030799,CG4872,X,16881347,16882790,1443
FBgn0030801,Polr3I,X,16884581,16886612,2031
FBgn0030803,CG4880,X,16886818,16888729,1911
FBgn0027556,CG4928,X,16913180,16938209,25029
FBgn0053252,CG33252,X,16896215,16897187,972
FBgn0030802,DENR,X,16885546,16886560,1014
FBgn0030800,Nprl2,X,16882509,16884365,1856
FBgn0030798,CG13003,X,16844807,16876544,31737
FBgn0030797,CG13004,X,16826681,16835520,8839
FBgn0030793,Rai1,X,16801929,16803344,1415
FBgn0030791,CG9132,X,16796902,16800710,3808
FBgn0030789,Rrp45,X,16789405,16791266,1861
FBgn0030787,CG9609,X,16785115,16787008,1893
FBgn0001250,if,X,16752189,16783434,31245
FBgn0027528,goe,X,16727304,16751910,24606
FBgn0030777,CG9672,X,16705971,16706874,903
FBgn0030774,sphe,X,16700446,16701972,1526
FBgn0030773,CG9676,X,16699152,16700170,1018
FBgn0030770,CG13010,X,16678265,16678945,680
FBgn0030769,CG13012,X,16668818,16676753,7935
FBgn0015336,CG15865,X,16660898,16664455,3557
FBgn0030768,Nemp,X,16653220,16655015,1795
FBgn0030808,RhoGAP15B,X,16943290,16956234,12944
FBgn0030813,CG4949,X,17078836,17081237,2401
FBgn0030814,CG4955,X,17081447,17083356,1909
FBgn0030816,CG16700,X,17091854,17098488,6634
FBgn0030817,CG4991,X,17091854,17104562,12708
FBgn0000163,baz,X,17160006,17200728,40722
FBgn0052564,CG32564,X,17206407,17207854,1447
FBgn0030828,CG5162,X,17215304,17217365,2061
FBgn0030829,CG12998,X,17218667,17219787,1120
FBgn0030830,CG5172,X,17221442,17222651,1209
FBgn0002590,RpS5a,X,17143588,17148264,4676
FBgn0065032,Arpc3B,X,17104571,17105852,1281
FBgn0030815,CG8945,X,17080423,17087675,7252
FBgn0030812,wcy,X,17068717,17077897,9180
FBgn0030809,Ubr1,X,16956232,16968679,12447
FBgn0030806,CG13001,X,16941086,16942871,1785
FBgn0030805,wus,X,16938244,16940873,2629
FBgn0030838,CG5445,X,17282496,17305475,22979
FBgn0004854,B-H2,X,17314581,17324175,9594
FBgn0011758,B-H1,X,17397478,17403278,5800
FBgn0030839,ENGase,X,17423591,17428735,5144
FBgn0030841,CG8568,X,17448990,17452543,3553
FBgn0040877,CG12994,X,17422320,17443994,21674
FBgn0027602,CG8611,X,17413267,17422145,8878
FBgn0024238,Fim,X,17285704,17301929,16225
FBgn0030837,CG8661,X,17283762,17284500,738
FBgn0030834,CG8675,X,17248372,17249502,1130
FBgn0030833,CG8915,X,17240468,17245001,4533
FBgn0030847,CG12991,X,17579861,17599314,19453
FBgn0030846,CG12992,X,17588865,17591706,2841
FBgn0026313,X11L,X,17599608,17606879,7271
FBgn0030853,ND-24,X,17632089,17633509,1420
FBgn0030855,CG5800,X,17636281,17639003,2722
FBgn0026192,par-6,X,17703352,17707096,3744
FBgn0024184,unc-4,X,17768569,17778708,10139
FBgn0026058,OdsH,X,17791010,17814011,23001
FBgn0030870,CG6398,X,17830828,17841705,10877
FBgn0000617,Taf9,X,17842161,17843348,1187
FBgn0030872,Ucp4A,X,17844949,17848223,3274
FBgn0052557,Mco4,X,17852958,17856129,3171
FBgn0052554,CG32554,X,17851869,17852685,816
FBgn0030873,CG15814,X,17848110,17850342,2232
FBgn0030871,CG8142,X,17843343,17844704,1361
FBgn0030869,Socs16D,X,17820764,17827564,6800
FBgn0030864,CG8173,X,17707401,17709653,2252
FBgn0030859,CG12990,X,17669208,17671888,2680
FBgn0030858,IntS2,X,17652761,17656818,4057
FBgn0026375,RhoGAPp190,X,17639147,17652562,13415
FBgn0030854,CG8289,X,17633691,17636044,2353
FBgn0030851,CG8326,X,17628164,17629492,1328
FBgn0030850,stas,X,17623221,17627895,4674
FBgn0028343,Ankle2,X,17571854,17579229,7375
FBgn0030876,Srx,X,17856974,17858610,1636
FBgn0030878,CG6769,X,17861002,17862775,1773
FBgn0030881,CG12985,X,17883718,17885238,1520
FBgn0030882,Gss1,X,17889547,17898603,9056
FBgn0030884,CG6847,X,17911462,17924163,12701
FBgn0030891,Ada3,X,18085761,18088418,2657
FBgn0021765,scu,X,18091259,18092853,1594
FBgn0030893,RhoGAP16F,X,18093145,18097413,4268
FBgn0022724,Taf8,X,18101970,18103482,1512
FBgn0030895,CG7135,X,18103653,18105393,1740
FBgn0052553,lncRNA:CR32553,X,18124575,18127027,2452
FBgn0030894,Mvb12,X,18097558,18101314,3756
FBgn0030890,CG7536,X,18078491,18088532,10041
FBgn0030886,CG12672,X,18005897,18007606,1709
FBgn0030883,CG7772,X,17906031,17907261,1230
FBgn0030877,Arp8,X,17858379,17860800,2421
FBgn0083228,Frq2,X,18177612,18204407,26795
FBgn0030914,CG6106,X,18358881,18362527,3646
FBgn0030915,CG6179,X,18380082,18381479,1397
FBgn0022355,Tsf1,X,18387084,18390344,3260
FBgn0030921,CG6290,X,18437490,18438233,743
FBgn0052551,CG32551,X,18438868,18439260,392
FBgn0052548,CG32548,X,18435719,18440581,4862
FBgn0052549,Nt5b,X,18390498,18410144,19646
FBgn0008635,betaCOP,X,18381549,18385242,3693
FBgn0004957,por,X,18377521,18379854,2333
FBgn0030913,kairos,X,18322958,18356191,33233
FBgn0030912,CG6023,X,18314124,18321193,7069
FBgn0004956,upd1,X,18305354,18309291,3937
FBgn0030904,upd2,X,18240654,18243284,2630
FBgn0027087,HisRS,X,18515428,18520445,5017
FBgn0030938,CG15047,X,18528683,18529593,910
FBgn0030943,Nup35,X,18648182,18649489,1307
FBgn0001079,fu,X,18657755,18661204,3449
FBgn0004959,phtm,X,18685766,18688433,2667
FBgn0030949,Cyp308a1,X,18709865,18711638,1773
FBgn0010383,Cyp18a1,X,18688538,18693042,4504
FBgn0030947,CG6696,X,18660472,18662153,1681
FBgn0030946,CG6659,X,18653392,18657286,3894
FBgn0030945,Ing3,X,18650718,18653091,2373
FBgn0030944,Hou,X,18649396,18650444,1048
FBgn0027335,Rip11,X,18635642,18647648,12006
FBgn0030941,wgn,X,18624042,18634908,10866
FBgn0030940,CG15040,X,18606610,18617589,10979
FBgn0030936,CG6481,X,18521074,18522445,1371
FBgn0030933,CG6470,X,18512829,18514867,2038
FBgn0030932,Ggt-1,X,18505883,18512521,6638
FBgn0010194,Wnt5,X,18501401,18505405,4004
FBgn0030930,Pgant7,X,18495067,18499986,4919
FBgn0030929,CG15043,X,18493193,18494168,975
FBgn0030927,CG15046,X,18487450,18489620,2170
FBgn0030926,psh,X,18484487,18486921,2434
FBgn0030925,Hayan,X,18479983,18483772,3789
FBgn0030955,CG6891,X,18775228,18781345,6117
FBgn0030958,CR6900,X,18785805,18786210,405
FBgn0030960,Atg101,X,18791668,18793517,1849
FBgn0030961,CG7058,X,18806694,18812002,5308
FBgn0030963,CG7101,X,18830591,18832123,1532
FBgn0030964,Pvf1,X,18832682,18842901,10219
FBgn0030969,Usp39,X,18858203,18860072,1869
FBgn0052544,CG32544,X,18860284,18861964,1680
FBgn0030973,CG7332,X,18884513,18888860,4347
FBgn0030975,SdhBL,X,18894446,18896581,2135
FBgn0030976,CG7378,X,18900410,18911843,11433
FBgn0030974,Flacc,X,18888978,18893636,4658
FBgn0030970,CG7326,X,18861197,18863776,2579
FBgn0030968,CG7322,X,18855873,18857757,1884
FBgn0030966,shop,X,18846389,18848566,2177
FBgn0001090,bnb,X,18794246,18797687,3441
FBgn0030959,CG6961,X,18786142,18788210,2068
FBgn0030956,CG18259,X,18781265,18783494,2229
FBgn0030954,CCKLR-17D3,X,18764483,18774027,9544
FBgn0030980,CG7406,X,19077720,19078592,872
FBgn0030981,CG14191,X,19081665,19082566,901
FBgn0030991,CG7453,X,19180173,19182024,1851
FBgn0030992,CG33253,X,19183421,19187278,3857
FBgn0030993,Mec2,X,19188035,19190193,2158
FBgn0030994,HP1D3csd,X,19190214,19191029,815
FBgn0030996,CG14194,X,19193555,19196037,2482
FBgn0030999,Mur18B,X,19213254,19214938,1684
FBgn0031001,CG7884,X,19220622,19235910,15288
FBgn0031003,CG7889,X,19243631,19245224,1593
FBgn0031005,Hs3st-B,X,19248639,19252045,3406
FBgn0040068,Vav,X,19261820,19273280,11460
FBgn0031012,CG8051,X,19301330,19307925,6595
FBgn0031011,CG8034,X,19281232,19298162,16930
FBgn0031010,CG8028,X,19277176,19280349,3173
FBgn0052536,CG32536,X,19275004,19276898,1894
FBgn0052537,CG32537,X,19273349,19276539,3190
FBgn0031008,CG8010,X,19266656,19268896,2240
FBgn0031006,rictor,X,19252111,19261240,9129
FBgn0031004,CG7992,X,19245158,19247250,2092
FBgn0031002,CG14196,X,19236059,19241840,5781
FBgn0027603,Ulp1,X,19202103,19208187,6084
FBgn0030997,CG7990,X,19196058,19201979,5921
FBgn0030995,CG7914,X,19192219,19193448,1229
FBgn0030990,CG7556,X,19176109,19179830,3721
FBgn0030989,Inx5,X,19168777,19170883,2106
FBgn0030985,Obp18a,X,19135081,19135868,787
FBgn0031018,narya,X,19475063,19476055,992
FBgn0031020,Naa15-16,X,19479984,19484643,4659
FBgn0031021,ND-18,X,19492421,19493337,916
FBgn0027621,Pfrx,X,19495505,19509350,13845
FBgn0031023,CG14200,X,19495505,19518402,22897
FBgn0000257,car,X,19566019,19569401,3382
FBgn0031034,CG14205,X,19592609,19595548,2939
FBgn0031037,CG14207,X,19605199,19611413,6214
FBgn0031040,CG14210,X,19616196,19616825,629
FBgn0031044,MKP-4,X,19623114,19625729,2615
FBgn0031045,CG14212,X,19625705,19626601,896
FBgn0031047,Rcd-1,X,19638767,19640746,1979
FBgn0031049,Sec61gamma,X,19643327,19644518,1191
FBgn0031052,Elys,X,19652305,19659407,7102
FBgn0031054,Ssu72,X,19664561,19666866,2305
FBgn0004057,Zw,X,19667252,19672353,5101
FBgn0031057,Ubqn,X,19683808,19687658,3850
FBgn0010341,Cdc42,X,19697091,19699938,2847
FBgn0031059,CG14229,X,19693977,19695250,1273
FBgn0043903,dome,X,19676061,19683518,7457
FBgn0031055,et,X,19672312,19675891,3579
FBgn0031053,CG14223,X,19659442,19663971,4529
FBgn0031051,Ranbp21,X,19646306,19652269,5963
FBgn0031050,Arp10,X,19644531,19646176,1645
FBgn0031048,CG12237,X,19641191,19642869,1678
FBgn0031043,Naa20A,X,19621451,19623074,1623
FBgn0031042,CG14221,X,19618819,19621245,2426
FBgn0031036,CG14220,X,19599803,19601851,2048
FBgn0031031,CG14218,X,19580350,19581981,1631
FBgn0031030,Tao,X,19569721,19579800,10079
FBgn0026430,Grip84,X,19559431,19565764,6333
FBgn0052532,CG32532,X,19531851,19547482,15631
FBgn0027291,Idh3a,X,19518428,19521810,3382
FBgn0040890,ksh,X,19494420,19494992,572
FBgn0031022,CG12204,X,19493292,19494401,1109
FBgn0020261,pcm,X,19485759,19492011,6252
FBgn0044030,mRpS14,X,19479382,19480238,856
FBgn0052533,CG32533,X,19474156,19479411,5255
FBgn0031062,CG14230,X,19704176,19706417,2241
FBgn0031064,CG12531,X,19718923,19730199,11276
FBgn0010380,AP-1-2beta,X,19731004,19734581,3577
FBgn0031065,CG14234,X,19735570,19740456,4886
FBgn0052528,parvin,X,19746041,19748458,2417
FBgn0031068,Alr,X,19748314,19750167,1853
FBgn0031069,Abcd3,X,19750770,19759280,8510
FBgn0031078,Nup205,X,19852214,19859379,7165
FBgn0031077,THADA,X,19859743,19865524,5781
FBgn0031070,CG12702,X,19759173,19764874,5701
FBgn0042132,CG18809,X,19741224,19744335,3111
FBgn0040089,meso18E,X,19706418,19713045,6627
FBgn0031061,CG14232,X,19701927,19704259,2332
FBgn0031060,Tcs4,X,19699820,19701755,1935
FBgn0031066,COX6B,X,19740537,19744335,3798
FBgn0036936,CG14185,3L,20106094,20107557,1463
FBgn0005198,gig,3L,20129181,20139010,9829
FBgn0036945,Ssk,3L,20188522,20189779,1257
FBgn0036956,CG13813,3L,20231669,20233255,1586
FBgn0036959,CG6951,3L,20241267,20245312,4045
FBgn0024814,Clc,3L,20241053,20243735,2682
FBgn0036967,SCCRO4,3L,20299410,20309511,10101
FBgn0036969,Spn77Bb,3L,20320952,20322358,1406
FBgn0052225,CG32225,3L,20304310,20306283,1973
FBgn0036964,FRG1,3L,20295802,20296971,1169
FBgn0052227,gogo,3L,20268859,20295133,26274
FBgn0036962,CG17122,3L,20273389,20275335,1946
FBgn0036958,CG17233,3L,20233173,20241903,8730
FBgn0036942,CG7328,3L,20139210,20140607,1397
FBgn0036941,CG7335,3L,20132032,20133268,1236
FBgn0036940,obst-J,3L,20130451,20131743,1292
FBgn0036939,CG7365,3L,20124298,20127381,3083
FBgn0036937,Ir76b,3L,20108484,20111534,3050
FBgn0036935,CG14186,3L,20098084,20103827,5743
FBgn0036934,sNPF-R,3L,20058511,20089007,30496
FBgn0036932,Lamtor1,3L,20027819,20029020,1201
FBgn0036909,Ccdc58,3L,19805181,19806932,1751
FBgn0024889,Kap-alpha1,3L,19807232,19810398,3166
FBgn0052221,CG32221,3L,19834670,19836413,1743
FBgn0001324,kto,3L,19836614,19844944,8330
FBgn0020389,Papss,3L,19845293,19860925,15632
FBgn0036913,Usp32,3L,19871139,19881783,10644
FBgn0036915,Prp3,3L,19910300,19912504,2204
FBgn0028695,Rpn1,3L,19915051,19918160,3109
FBgn0036918,Pfdn6,3L,19923671,19924688,1017
FBgn0036919,Grasp65,3L,19924943,19927175,2232
FBgn0036921,RhoGDI,3L,19928743,19932930,4187
FBgn0004852,Ac76E,3L,19939287,19977960,38673
FBgn0036923,CG17732,3L,19981685,19984191,2506
FBgn0036925,schuy,3L,19986093,19988072,1979
FBgn0036926,CG7646,3L,19991887,19996269,4382
FBgn0013303,Nca,3L,19991887,19997568,5681
FBgn0036928,Tom20,3L,20000644,20002446,1802
FBgn0036929,CG7668,3L,20002736,20004834,2098
FBgn0036931,CG14183,3L,20024687,20027835,3148
FBgn0036927,Gabat,3L,19997714,20000686,2972
FBgn0005633,fln,3L,19989551,19991220,1669
FBgn0052220,Csas,3L,19988027,19988991,964
FBgn0036922,CG14182,3L,19978713,19979812,1099
FBgn0036920,CG8004,3L,19927194,19928508,1314
FBgn0020887,Su(z)12,3L,19918242,19923462,5220
FBgn0014037,Su(Tpl),3L,19889120,19909410,20290
FBgn0003744,trc,3L,19830864,19834304,3440
FBgn0023094,cyc,3L,19813770,19815938,2168
FBgn0036910,Cyp305a1,3L,19810403,19813339,2936
FBgn0040786,CG14104,3L,19806811,19807199,388
FBgn0036908,TORIP,3L,19803738,19805080,1342
FBgn0036906,CG14102,3L,19798975,19801291,2316
FBgn0036880,Cpr76Bc,3L,19520945,19527272,6327
FBgn0036881,Cpr76Bd,3L,19532743,19538289,5546
FBgn0260461,Rcd7,3L,19545110,19547293,2183
FBgn0036886,CG9300,3L,19552420,19554767,2347
FBgn0036888,CG9330,3L,19586253,19589111,2858
FBgn0010417,Taf6,3L,19599088,19601382,2294
FBgn0036890,CG9368,3L,19601633,19604120,2487
FBgn0036891,CG9372,3L,19606208,19608368,2160
FBgn0036893,PIG-F,3L,19612455,19613489,1034
FBgn0029094,asf1,3L,19618894,19620398,1504
FBgn0036895,ms(3)76Cc,3L,19620502,19624309,3807
FBgn0004623,Gbeta76C,3L,19687637,19689992,2355
FBgn0036899,tey,3L,19650506,19664104,13598
FBgn0022774,Oat,3L,19647280,19649851,2571
FBgn0036897,Rnf146,3L,19637207,19642816,5609
FBgn0036896,wnd,3L,19624406,19635783,11377
FBgn0036892,Lon,3L,19607857,19612199,4342
FBgn0020277,lush,3L,19604398,19606090,1692
FBgn0005386,ash1,3L,19590773,19598755,7982
FBgn0036889,CG14100,3L,19589072,19590524,1452
FBgn0036887,CG9231,3L,19585093,19586003,910
FBgn0005564,Shal,3L,19566851,19584568,17717
FBgn0036882,Dred,3L,19538425,19544205,5780
FBgn0040075,rept,3L,19255340,19257111,1771
FBgn0036856,Mettl5,3L,19263766,19266838,3072
FBgn0036860,CG14086,3L,19275791,19279919,4128
FBgn0028380,fal,3L,19294564,19298830,4266
FBgn0052205,hpRNA:CR32205,3L,19420390,19424183,3793
FBgn0003089,pip,3L,19298623,19337609,38986
FBgn0036862,Gbs-76A,3L,19281364,19292766,11402
FBgn0036861,CG14089,3L,19280120,19280800,680
FBgn0036857,Aldh7A1,3L,19266473,19268913,2440
FBgn0017578,Max,3L,19262232,19264184,1952
FBgn0026630,nes,3L,19257282,19260679,3397
FBgn0036853,mRpL21,3L,19253290,19255061,1771
FBgn0036834,CG6836,3L,18950629,18955406,4777
FBgn0036835,CG14075,3L,18984961,18985634,673
FBgn0036843,Sfxn2,3L,19063165,19066151,2986
FBgn0036846,MESR6,3L,19092670,19094760,2090
FBgn0036849,CG14079,3L,19097999,19099064,1065
FBgn0016797,fz2,3L,19140975,19235373,94398
FBgn0052203,Spn75F,3L,19128450,19129665,1215
FBgn0036851,CG14082,3L,19105381,19138975,33594
FBgn0036850,Gem2,3L,19099123,19100363,1240
FBgn0036848,Naxd,3L,19096399,19097709,1310
FBgn0036847,CNPYb,3L,19094890,19096217,1327
FBgn0036844,Mkp3,3L,19066155,19086426,20271
FBgn0036842,Ugt316A1,3L,19059400,19062816,3416
FBgn0002945,nkd,3L,19003741,19045449,41708
FBgn0036839,SmydA-2,3L,19000985,19003252,2267
FBgn0036838,CG3808,3L,18997875,19000608,2733
FBgn0036837,CG18135,3L,18990026,18998283,8257
FBgn0036836,CG11619,3L,18985905,18988323,2418
FBgn0052204,CG32204,3L,18922419,18946038,23619
FBgn0036833,CG3819,3L,18920430,18922108,1678
FBgn0036801,MYPT-75D,3L,18625959,18667177,41218
FBgn0040323,GNBP1,3L,18675800,18677876,2076
FBgn0036807,CG6893,3L,18694187,18695648,1461
FBgn0036811,MED11,3L,18745856,18746623,767
FBgn0036813,Atg3,3L,18748687,18750483,1796
FBgn0036815,HipHop,3L,18821171,18822353,1182
FBgn0052027,lncRNA:CR32027,3L,18841579,18842786,1207
FBgn0036818,CG14074,3L,18866225,18867431,1206
FBgn0036819,Dysb,3L,18867771,18869219,1448
FBgn0036820,Grx1,3L,18869230,18870057,827
FBgn0014075,Uggt,3L,18872747,18878245,5498
FBgn0036822,NijB,3L,18892383,18893278,895
FBgn0036825,RpL26,3L,18898875,18900408,1533
FBgn0036827,CG6843,3L,18901594,18902952,1358
FBgn0036828,Prp6,3L,18905372,18908974,3602
FBgn0036830,COX6AL2,3L,18908260,18914150,5890
FBgn0036829,Ir75d,3L,18908260,18911182,2922
FBgn0027057,CSN1b,3L,18903057,18904930,1873
FBgn0036826,arx,3L,18900595,18901554,959
FBgn0036824,CG3902,3L,18893120,18898293,5173
FBgn0036821,CG3961,3L,18878250,18890483,12233
FBgn0025807,Rad9,3L,18870045,18872553,2508
FBgn0036816,Indy,3L,18828632,18846267,17635
FBgn0036814,CG14073,3L,18802265,18820675,18410
FBgn0001078,ftz-f1,3L,18750607,18801309,50702
FBgn0036812,Nufip,3L,18746611,18748367,1756
FBgn0036806,Cyp12c1,3L,18684259,18686319,2060
FBgn0036805,Chmp1,3L,18682895,18684061,1166
FBgn0036804,Sgf11,3L,18681037,18681836,799
FBgn0040322,GNBP2,3L,18673474,18675413,1939
FBgn0042134,Capr,3L,18668153,18673324,5171
FBgn0052198,CG32198,3L,18526976,18527445,469
FBgn0036791,CG7271,3L,18588759,18590165,1406
FBgn0013717,not,3L,18618305,18622129,3824
FBgn0003683,term,3L,18592303,18593771,1468
FBgn0028416,Met75Ca,3L,18472143,18472384,241
FBgn0028415,Met75Cb,3L,18469378,18469618,240
FBgn0036787,CG4306,3L,18461957,18463163,1206
FBgn0052196,CG32196,3L,18459464,18461024,1560
FBgn0036786,skl,3L,18438561,18439942,1381
FBgn0011706,rpr,3L,18397535,18398435,900
FBgn0036774,mRpS26,3L,18106579,18107499,920
FBgn0002901,mus304,3L,18109814,18112847,3033
FBgn0036777,CG7341,3L,18112959,18121003,8044
FBgn0052195,CG32195,3L,18112959,18119150,6191
FBgn0020300,geko,3L,18139402,18145418,6016
FBgn0015946,grim,3L,18302719,18304417,1698
FBgn0036785,CG13700,3L,18298742,18301260,2518
FBgn0036784,CG5103,3L,18292125,18294262,2137
FBgn0003997,hid,3L,18167745,18185641,17896
FBgn0036781,CG13699,3L,18154897,18162522,7625
FBgn0036778,Cyp312a1,3L,18128940,18132689,3749
FBgn0036775,Polr3D,3L,18107848,18109574,1726
FBgn0036773,CG13698,3L,18088417,18106149,17732
FBgn0052194,lncRNA:CR32194,3L,18085305,18087058,1753
FBgn0001134,Grd,3L,17823333,17839767,16434
FBgn0036763,TrpRS-m,3L,17849727,17852453,2726
FBgn0036765,CG7408,3L,17879096,17883653,4557
FBgn0036768,CG7402,3L,17887705,17891404,3699
FBgn0036771,Wdr92,3L,17908143,17909683,1540
FBgn0052192,CG32192,3L,18040317,18041738,1421
FBgn0000568,Eip75B,3L,17950953,18064696,113743
FBgn0036772,CG5290,3L,17909483,17912565,3082
FBgn0036770,Prestin,3L,17898889,17907812,8923
FBgn0036769,Tsp74F,3L,17891820,17895862,4042
FBgn0036764,CG5535,3L,17852624,17856794,4170
FBgn0036761,MED19,3L,17843725,17846501,2776
FBgn0036760,CG5567,3L,17841540,17843544,2004
FBgn0036759,CG5577,3L,17838650,17841427,2777
FBgn0036757,Ir75a,3L,17815570,17817921,2351
FBgn0036756,Cln3,3L,17809231,17814119,4888
FBgn0052191,CG32191,3L,17806451,17809146,2695
FBgn0052187,CG32187,3L,17804916,17806365,1449
FBgn0036754,ais,3L,17802490,17804715,2225
FBgn0052190,NUCB1,3L,17797738,17802279,4541
FBgn0036732,Oatp74D,3L,17487118,17511693,24575
FBgn0052185,edin,3L,17494880,17495300,420
FBgn0036734,CG7564,3L,17514298,17524740,10442
FBgn0036741,anchor,3L,17621824,17630971,9147
FBgn0036742,CG7497,3L,17633449,17638001,4552
FBgn0036745,CG7484,3L,17654617,17655645,1028
FBgn0052183,Ccn,3L,17690015,17748839,58824
FBgn0036749,CG7460,3L,17740540,17742540,2000
FBgn0052181,CG32181,3L,17759697,17762904,3207
FBgn0036752,Adgf-A,3L,17751731,17764158,12427
FBgn0043025,Adgf-A2,3L,17754936,17764158,9222
FBgn0036750,CG6034,3L,17745173,17746860,1687
FBgn0036746,Crtc,3L,17659818,17669234,9416
FBgn0052179,Krn,3L,17649562,17654280,4718
FBgn0004401,Pep,3L,17638103,17645036,6933
FBgn0036740,Vps60,3L,17620123,17621625,1502
FBgn0036735,Edc3,3L,17525333,17529861,4528
FBgn0036733,U4-U6-60K,3L,17511855,17513912,2057
FBgn0052177,Ndfip,3L,17647442,17654280,6838
FBgn0036714,CG7692,3L,17351822,17358056,6234
FBgn0015550,tap,3L,17359682,17361811,2129
FBgn0040793,COX7B,3L,17425477,17426282,805
FBgn0036725,CG18265,3L,17439401,17457461,18060
FBgn0036726,QIL1,3L,17465945,17466768,823
FBgn0036727,SecCl,3L,17470127,17474517,4390
FBgn0036728,UQCR-Q,3L,17474761,17476124,1363
FBgn0036730,qjt,3L,17479096,17480141,1045
FBgn0036731,CG6333,3L,17480129,17486230,6101
FBgn0036729,CG13733,3L,17477795,17478926,1131
FBgn0036723,CG12229,3L,17434472,17436431,1959
FBgn0052174,Coq4,3L,17428936,17433621,4685
FBgn0042641,frc,3L,17428936,17433190,4254
FBgn0053052,Gorab,3L,17427305,17428836,1531
FBgn0053051,Polr3G,3L,17426286,17427130,844
FBgn0027660,blot,3L,17396031,17421514,25483
FBgn0026197,lncRNA:noe,3L,17400272,17401348,1076
FBgn0036717,CG13731,3L,17383636,17388956,5320
FBgn0036715,Cad74A,3L,17367753,17379530,11777
FBgn0036710,CG6479,3L,17337172,17339262,2090
FBgn0036702,Afg3l2,3L,17238613,17242128,3515
FBgn0052170,CG32170,3L,16877309,16879372,2063
FBgn0010352,Ogdh,3L,16954822,16968724,13902
FBgn0036686,CG7728,3L,17016536,17020270,3734
FBgn0036688,Fit2,3L,17024328,17027117,2789
FBgn0036691,beg,3L,17035668,17036865,1197
FBgn0036695,Papst2,3L,17042797,17044465,1668
FBgn0036697,rogdi,3L,17049512,17055454,5942
FBgn0036698,CG7724,3L,17055613,17058533,2920
FBgn0036696,Pop5,3L,17044401,17045038,637
FBgn0036690,Ilp8,3L,17029812,17032080,2268
FBgn0011293,a10,3L,17023123,17023741,618
FBgn0036687,CG6652,3L,17020348,17022856,2508
FBgn0036684,CG3764,3L,16994717,17012565,17848
FBgn0036679,CG13022,3L,16938330,16938952,622
FBgn0036678,CG11905,3L,16928381,16935536,7155
FBgn0036677,CG13023,3L,16923914,16927434,3520
FBgn0028693,Rpn12,3L,16583028,16584022,994
FBgn0052163,CG32163,3L,16587157,16588143,986
FBgn0042178,Apl,3L,16595181,16600459,5278
FBgn0042177,Arts,3L,16602851,16608146,5295
FBgn0025558,CG4101,3L,16612486,16612950,464
FBgn0041721,snRNA:U12,3L,16653769,16654006,237
FBgn0036652,CG13032,3L,16673964,16676264,2300
FBgn0036654,CG9692,3L,16704973,16706428,1455
FBgn0000414,Dab,3L,16712126,16724575,12449
FBgn0036659,CG9701,3L,16733546,16739364,5818
FBgn0004108,Nrt,3L,16766072,16777465,11393
FBgn0036661,CG9705,3L,16780100,16782419,2319
FBgn0036662,CG9706,3L,16783010,16785246,2236
FBgn0021768,nudC,3L,16804994,16819532,14538
FBgn0036666,TSG101,3L,16842294,16844585,2291
FBgn0036668,Zcchc7,3L,16845386,16852350,6964
FBgn0052161,CG32161,3L,16846227,16847000,773
FBgn0003410,sina,3L,16853751,16858712,4961
FBgn0036671,CG9951,3L,16863164,16864989,1825
FBgn0003250,Rh4,3L,16852527,16862517,9990
FBgn0036667,kud,3L,16844568,16844991,423
FBgn0036665,CG13024,3L,16809658,16829074,19416
FBgn0036663,CG9674,3L,16787573,16807731,20158
FBgn0025582,eIF3e,3L,16785242,16786941,1699
FBgn0004556,Dbp73D,3L,16728496,16730818,2322
FBgn0043578,PGRP-SB1,3L,16727299,16727989,690
FBgn0036656,CG13026,3L,16724678,16726169,1491
FBgn0063485,Lasp,3L,16676406,16711677,35271
FBgn0040512,zetaCOP,3L,16671664,16673555,1891
FBgn0010223,Galphaf,3L,16662557,16667934,5377
FBgn0000017,Abl,3L,16615866,16647882,32016
FBgn0017572,Mo25,3L,16613218,16615472,2254
FBgn0004465,Su(P),3L,16610662,16612199,1537
FBgn0002284,Prosbeta6,3L,16609400,16610418,1018
FBgn0036648,CG4098,3L,16608138,16609347,1209
FBgn0027500,spd-2,3L,16591207,16595014,3807
FBgn0036643,Syx8,3L,16586108,16587057,949
FBgn0042201,Nplp3,3L,16318024,16318690,666
FBgn0036606,CG13060,3L,16319856,16320454,598
FBgn0036610,CG13058,3L,16328841,16329534,693
FBgn0053061,CG33061,3L,16329795,16331227,1432
FBgn0053060,CG33060,3L,16331040,16331767,727
FBgn0040074,retinin,3L,16331933,16332789,856
FBgn0040794,CG13056,3L,16333313,16333782,469
FBgn0036612,CG4998,3L,16339003,16345241,6238
FBgn0036617,Cpr72Ea,3L,16362603,16363750,1147
FBgn0036618,Cpr72Eb,3L,16364899,16365707,808
FBgn0036620,CG4842,3L,16368389,16369518,1129
FBgn0042137,CG18814,3L,16369826,16370945,1119
FBgn0036624,RAF2,3L,16386327,16390816,4489
FBgn0036627,Gagr,3L,16394586,16396880,2294
FBgn0028399,Serinc,3L,16412722,16415386,2664
FBgn0053158,CG33158,3L,16419597,16496560,76963
FBgn0003515,st,3L,16497651,16500460,2809
FBgn0036641,Smn,3L,16580398,16581547,1149
FBgn0026061,Mipp1,3L,16563448,16573334,9886
FBgn0004569,aos,3L,16470386,16483650,13264
FBgn0027080,TyrRS,3L,16417349,16419302,1953
FBgn0036629,GluRS-m,3L,16415292,16417177,1885
FBgn0036623,Agpat3,3L,16381772,16385957,4185
FBgn0036622,Agpat4,3L,16378974,16381570,2596
FBgn0036621,roq,3L,16370938,16378566,7628
FBgn0036619,Cpr72Ec,3L,16365894,16367340,1446
FBgn0011693,Pdh,3L,16353233,16354297,1064
FBgn0036614,Golgin104,3L,16348747,16351951,3204
FBgn0036605,CG13041,3L,16318954,16319526,572
FBgn0036600,CG13043,3L,16305225,16305870,645
FBgn0044028,Notum,3L,16023480,16032752,9272
FBgn0036560,CG5895,3L,16035485,16037227,1742
FBgn0005536,Mbs,3L,16051959,16082026,30067
FBgn0036563,CG13075,3L,16083993,16085264,1271
FBgn0036566,ClC-c,3L,16090454,16096151,5697
FBgn0036568,ATPsynbetaL,3L,16097834,16100088,2254
FBgn0036569,IleRS-m,3L,16100280,16103482,3202
FBgn0010280,Taf4,3L,16113212,16121651,8439
FBgn0036571,Strump,3L,16122002,16126052,4050
FBgn0011016,SsRbeta,3L,16129617,16130983,1366
FBgn0036579,Tmx3,3L,16229100,16231139,2039
FBgn0036581,MED10,3L,16232084,16232777,693
FBgn0036585,CG13071,3L,16262740,16263247,507
FBgn0040798,CG13069,3L,16265385,16265804,419
FBgn0036588,CG13068,3L,16269392,16269911,519
FBgn0036589,CG13067,3L,16271282,16271918,636
FBgn0036598,CG4982,3L,16301453,16302027,574
FBgn0036597,CG4962,3L,16294711,16295547,836
FBgn0036587,CG4950,3L,16265797,16268156,2359
FBgn0040801,CG13053,3L,16259037,16259722,685
FBgn0036584,CG13054,3L,16255852,16257191,1339
FBgn0036583,CG13055,3L,16249560,16252355,2795
FBgn0036580,PDCD-5,3L,16231081,16232038,957
FBgn0036577,CG13073,3L,16213051,16217303,4252
FBgn0036576,CG5151,3L,16137802,16164701,26899
FBgn0052152,CG32152,3L,16139501,16144036,4535
FBgn0036575,CG5157,3L,16136487,16137879,1392
FBgn0003076,Pgm1,3L,16126018,16128531,2513
FBgn0036570,IntS9,3L,16103432,16105627,2195
FBgn0036567,CG13074,3L,16095768,16097493,1725
FBgn0036565,CG5235,3L,16087627,16090392,2765
FBgn0015025,CkIIalpha-i1,3L,15816979,15818621,1642
FBgn0040230,dbo,3L,15826888,15832004,5116
FBgn0036536,CG12713,3L,15832464,15833947,1483
FBgn0036545,GXIVsPLA2,3L,15955096,15956465,1369
FBgn0036547,CG17032,3L,15958843,15960609,1766
FBgn0036549,CG10516,3L,15968204,15969902,1698
FBgn0036550,CG17026,3L,15975368,15976428,1060
FBgn0036551,CG17029,3L,15976870,15978435,1565
FBgn0036552,CG17028,3L,15978524,15980004,1480
FBgn0036553,CG17027,3L,15980100,15981888,1788
FBgn0000115,Arl1,3L,15983135,15984362,1227
FBgn0036557,mRpS31,3L,16005193,16006599,1406
FBgn0036556,hzg,3L,15992669,16004736,12067
FBgn0000212,brm,3L,15970082,15982869,12787
FBgn0000489,Pka-C3,3L,15925805,15954797,28992
FBgn0052150,meru,3L,15837773,15844062,6289
FBgn0036538,CG15715,3L,15835693,15837482,1789
FBgn0036537,CG18081,3L,15833795,15835388,1593
FBgn0036498,CG13455,3L,15496574,15498055,1481
FBgn0036500,CG7275,3L,15498959,15500561,1602
FBgn0036501,CG7272,3L,15500938,15503769,2831
FBgn0000565,MsrA,3L,15511052,15513202,2150
FBgn0004396,CrebA,3L,15535395,15553214,17819
FBgn0036510,SCCRO,3L,15563427,15565559,2132
FBgn0036512,Ufsp2,3L,15576570,15578674,2104
FBgn0036514,CG12301,3L,15580800,15583373,2573
FBgn0036515,AIMP2,3L,15583638,15585347,1709
FBgn0036518,RhoGAP71E,3L,15588860,15609125,20265
FBgn0036522,Phs,3L,15619901,15624130,4229
FBgn0036529,Pgant8,3L,15683872,15686598,2726
FBgn0010105,comm,3L,15721511,15728430,6919
FBgn0041160,comm2,3L,15697594,15699850,2256
FBgn0036520,CG13449,3L,15610631,15612828,2197
FBgn0036519,CG7650,3L,15608707,15610386,1679
FBgn0036516,CG7656,3L,15585431,15588175,2744
FBgn0036509,CG7739,3L,15560726,15563065,2339
FBgn0036505,CG7945,3L,15521711,15524137,2426
FBgn0004228,mex1,3L,15517424,15519592,2168
FBgn0036502,CG7841,3L,15505188,15508252,3064
FBgn0026738,CG7857,3L,15503600,15504894,1294
FBgn0040805,CG12355,3L,15492964,15495549,2585
FBgn0029114,Tollo,3L,15235619,15242832,7213
FBgn0036494,Toll-6,3L,15336692,15344315,7623
FBgn0036492,Best3,3L,15300915,15302785,1870
FBgn0036460,CG5114,3L,14982835,14984486,1651
FBgn0002778,mnd,3L,14985100,14991667,6567
FBgn0036461,Zip71B,3L,14992289,14997983,5694
FBgn0023174,Prosbeta2,3L,14999951,15001319,1368
FBgn0027088,GlyRS,3L,15095142,15097686,2544
FBgn0036479,CG13458,3L,15113557,15116373,2816
FBgn0036480,Cep135,3L,15116737,15128029,11292
FBgn0036484,Pex3,3L,15144355,15146379,2024
FBgn0036485,FucTA,3L,15147137,15154395,7258
FBgn0036487,Prp31,3L,15159100,15161138,2038
FBgn0036488,CG6878,3L,15161817,15162470,653
FBgn0036489,CG7011,3L,15160876,15163628,2752
FBgn0036486,Msh6,3L,15154233,15158562,4329
FBgn0047178,CG32147,3L,15143063,15144059,996
FBgn0036483,CG12316,3L,15131508,15136934,5426
FBgn0036482,CG13457,3L,15127940,15131378,3438
FBgn0036481,CG16959,3L,15119878,15125321,5443
FBgn0036476,sstn,3L,15090823,15094719,3896
FBgn0036474,Or71a,3L,15076907,15078447,1540
FBgn0036463,Reck,3L,15001238,15014062,12824
FBgn0036462,mRpL39,3L,14997981,14999666,1685
FBgn0003388,shd,3L,14614458,14622205,7747
FBgn0036433,CG9628,3L,14622796,14628174,5378
FBgn0041604,dlp,3L,14632601,14671609,39008
FBgn0036437,Dnaaf6,3L,14684768,14685842,1074
FBgn0036438,gdrd,3L,14691347,14691962,615
FBgn0036446,Mgat4a,3L,14762028,14767703,5675
FBgn0036450,Tdrd3,3L,14786791,14789665,2874
FBgn0036451,Helz,3L,14789935,14801089,11154
FBgn0036454,CG17839,3L,14805136,14882224,77088
FBgn0001120,gnu,3L,14802380,14803360,980
FBgn0029148,NHP2,3L,14801328,14802168,840
FBgn0036449,bmm,3L,14776496,14786412,9916
FBgn0036448,mop,3L,14769341,14776129,6788
FBgn0053260,Tsen34,3L,14760520,14761844,1324
FBgn0036440,CG17177,3L,14697313,14701678,4365
FBgn0036436,CG4914,3L,14674538,14678147,3609
FBgn0036423,CG3919,3L,14410626,14412732,2106
FBgn0026409,Mpcp2,3L,14537651,14540441,2790
FBgn0040318,HGTX,3L,14583222,14599540,16318
FBgn0028418,Lk,3L,14560139,14560764,625
FBgn0036428,Gbs-70E,3L,14540937,14550975,10038
FBgn0036427,CG4613,3L,14519760,14521690,1930
FBgn0003459,stwl,3L,14402930,14409939,7009
FBgn0036422,CG3868,3L,14400769,14402725,1956
FBgn0052141,saturn,3L,14203323,14204294,971
FBgn0036415,CG7768,3L,14218204,14218974,770
FBgn0036416,CG7924,3L,14233469,14234609,1140
FBgn0036417,CG7906,3L,14236635,14238272,1637
FBgn0001085,fz,3L,14274343,14368639,94296
FBgn0036419,CG13482,3L,14329346,14329885,539
FBgn0000411,D,3L,14175610,14178620,3010
FBgn0042630,Sox21b,3L,14112405,14131324,18919
FBgn0036411,Sox21a,3L,14103481,14108118,4637
FBgn0000639,Fbp1,3L,14094589,14098053,3464
FBgn0043550,Tsp68C,3L,13843656,13845316,1660
FBgn0029167,Hml,3L,13846054,13860001,13947
FBgn0036382,CG13737,3L,13878994,13883056,4062
FBgn0001108,DCTN1-p150,3L,13929387,13934656,5269
FBgn0052137,CG32137,3L,13939250,13962647,23397
FBgn0036389,ssp2,3L,13965203,13973067,7864
FBgn0001216,Hsc70-1,3L,13974061,13977761,3700
FBgn0036395,CG17361,3L,13997191,13998055,864
FBgn0036398,upSET,3L,14002127,14020148,18021
FBgn0036402,CG6650,3L,14031450,14034909,3459
FBgn0036403,CG6661,3L,14034776,14036751,1975
FBgn0026418,Hsp110,3L,14037019,14043686,6667
FBgn0036405,CG6833,3L,14051206,14052469,1263
FBgn0013563,Pex1,3L,14071892,14076123,4231
FBgn0036410,CG8100,3L,14083615,14086421,2806
FBgn0036406,CG13484,3L,14052428,14053079,651
FBgn0036397,Nprl3,3L,13999380,14001880,2500
FBgn0036396,CG17359,3L,13997900,13999251,1351
FBgn0036391,CG17364,3L,13977905,13993400,15495
FBgn0036390,CG13738,3L,13973123,13973477,354
FBgn0025874,Meics,3L,13962658,13964702,2044
FBgn0036386,CG8833,3L,13925882,13929000,3118
FBgn0026376,Rgl,3L,13906897,13925335,18438
FBgn0036381,CG8745,3L,13860027,13866905,6878
FBgn0036380,CG8757,3L,13840197,13842240,2043
FBgn0036368,CG10738,3L,13450770,13465539,14769
FBgn0036373,Tgi,3L,13486797,13502492,15695
FBgn0036376,Liprin-beta,3L,13513254,13516276,3022
FBgn0036377,CG10710,3L,13516273,13519605,3332
FBgn0036372,Abp1,3L,13483533,13486280,2747
FBgn0036369,CG10089,3L,13465552,13474787,9235
FBgn0036367,CG10116,3L,13456208,13457238,1030
FBgn0036366,JMJD7,3L,13449187,13450283,1096
FBgn0023095,caps,3L,13228692,13279642,50950
FBgn0036348,CG17687,3L,13349033,13354940,5907
FBgn0001256,ImpL1,3L,13382765,13383999,1234
FBgn0036364,CG14109,3L,13440910,13442420,1510
FBgn0036365,cmb,3L,13442594,13449245,6651
FBgn0036363,CG10140,3L,13439317,13440470,1153
FBgn0036360,CG10713,3L,13428839,13435229,6390
FBgn0036359,CG14105,3L,13425891,13426673,782
FBgn0052121,CG32121,3L,13416576,13422336,5760
FBgn0036356,CG10222,3L,13411122,13412453,1331
FBgn0002573,sens,3L,13396228,13401125,4897
FBgn0036354,Poc1,3L,13388299,13390006,1707
FBgn0036353,CG10171,3L,13385946,13387907,1961
FBgn0036351,CG14107,3L,13380359,13381346,987
FBgn0052119,CG32119,3L,13246864,13248702,1838
FBgn0036323,CG14118,3L,12892658,12894758,2100
FBgn0036329,CG11262,3L,12995135,12997418,2283
FBgn0036330,CG11263,3L,13006817,13007881,1064
FBgn0036331,CR14117,3L,13008285,13009450,1165
FBgn0036334,CG11267,3L,13016050,13016903,853
FBgn0036336,Icmt,3L,13018266,13019687,1421
FBgn0036340,Srrm1,3L,13036821,13040976,4155
FBgn0011284,RpS4,3L,13041756,13044234,2478
FBgn0036341,Syx13,3L,13044434,13046894,2460
FBgn0036342,CG11279,3L,13046977,13048919,1942
FBgn0010452,trn,3L,13114271,13118077,3806
FBgn0036337,Adk2,3L,13019715,13022688,2973
FBgn0036335,mRpL20,3L,13017149,13017867,718
FBgn0036333,MICAL-like,3L,13011976,13015332,3356
FBgn0036332,Cul6,3L,13009399,13011685,2286
FBgn0052115,CG32115,3L,12912027,12913646,1619
FBgn0036324,CG12520,3L,12901247,12902737,1490
FBgn0015904,ara,3L,12580672,12596018,15346
FBgn0015919,caup,3L,12609631,12621798,12167
FBgn0052111,lncRNA:CR32111,3L,12627934,12648280,20346
FBgn0014343,mirr,3L,12693639,12710249,16610
FBgn0014007,Ptp69D,3L,12734945,12741568,6623
FBgn0052112,CG32112,3L,12741718,12745154,3436
FBgn0052109,CG32109,3L,12745344,12746770,1426
FBgn0036305,CG10984,3L,12750119,12753402,3283
FBgn0052113,Vps13D,3L,12755049,12768605,13556
FBgn0036311,CG17666,3L,12781325,12784377,3052
FBgn0052110,CG32110,3L,12808721,12810096,1375
FBgn0036318,Wbp2,3L,12850165,12853169,3004
FBgn0036319,Ent3,3L,12853646,12857428,3782
FBgn0036317,CG10948,3L,12844254,12850117,5863
FBgn0036316,nebu,3L,12824880,12843106,18226
FBgn0036314,Sf3a2,3L,12813028,12814019,991
FBgn0036309,Hip1,3L,12768432,12773573,5141
FBgn0010235,Klc,3L,12746616,12750056,3440
FBgn0052105,Lmx1a,3L,12329232,12335901,6669
FBgn0036277,CG10418,3L,12336676,12337236,560
FBgn0011279,Obp69a,3L,12396171,12396957,786
FBgn0036286,CG10616,3L,12471728,12474428,2700
FBgn0036291,CG10681,3L,12501513,12502647,1134
FBgn0036300,Pmm2,3L,12534590,12535513,923
FBgn0036301,CG4069,3L,12535426,12537315,1889
FBgn0036299,Tsf2,3L,12530436,12533724,3288
FBgn0036298,nst,3L,12527215,12530171,2956
FBgn0004926,eIF2beta,3L,12525093,12526731,1638
FBgn0020388,Gcn5,3L,12521129,12524014,2885
FBgn0002466,sti,3L,12507998,12514815,6817
FBgn0036294,CG10654,3L,12505374,12507840,2466
FBgn0036292,CG10646,3L,12502467,12503894,1427
FBgn0036289,CG10657,3L,12491830,12497216,5386
FBgn0036288,CG10660,3L,12486668,12490676,4008
FBgn0036287,CG10663,3L,12474418,12485035,10617
FBgn0052102,CG32102,3L,12469072,12469784,712
FBgn0036285,toe,3L,12422510,12432668,10158
FBgn0020655,ArfGAP1,3L,12415026,12417580,2554
FBgn0052103,SCaMC,3L,12402295,12414842,12547
FBgn0036282,Smyd4-2,3L,12399539,12401935,2396
FBgn0052104,CG32104,3L,12393804,12399322,5518
FBgn0036279,Ncc69,3L,12368646,12391444,22798
FBgn0036278,CrzR,3L,12339116,12351544,12428
FBgn0011335,vers,3L,12116101,12118055,1954
FBgn0036248,ssp,3L,12118257,12119789,1532
FBgn0036249,CG11560,3L,12120019,12121185,1166
FBgn0046296,DEF8,3L,12132146,12133834,1688
FBgn0036257,RhoGAP68F,3L,12138868,12143380,4512
FBgn0013997,Nrx-IV,3L,12146519,12156990,10471
FBgn0052099,CG32099,3L,12149273,12150329,1056
FBgn0027843,CAH2,3L,12177601,12183347,5746
FBgn0036262,Miox,3L,12184984,12187860,2876
FBgn0000592,Est-6,3L,12188818,12190705,1887
FBgn0000594,Est-P,3L,12190733,12192528,1795
FBgn0036264,CG11529,3L,12197791,12199030,1239
FBgn0052100,CG32100,3L,12267528,12269803,2275
FBgn0036273,INPP5E,3L,12277655,12281476,3821
FBgn0036274,CG4328,3L,12290956,12296123,5167
FBgn0036272,Sms,3L,12271656,12277251,5595
FBgn0036271,Pbgs,3L,12269452,12271345,1893
FBgn0036266,Tsen54,3L,12204123,12206022,1899
FBgn0022709,Ak1,3L,12200322,12204082,3760
FBgn0036263,thoc6,3L,12190696,12193688,2992
FBgn0036260,Rh7,3L,12164205,12175482,11277
FBgn0036259,CG9760,3L,12157052,12163735,6683
FBgn0036258,eIF3l,3L,12143446,12146097,2651
FBgn0011455,ND-SGDH,3L,12137496,12138584,1088
FBgn0036254,CG5645,3L,12133771,12136706,2935
FBgn0022959,yps,3L,12121274,12125150,3876
FBgn0036205,CG14131,3L,11777073,11780485,3412
FBgn0036207,CG10907,3L,11793514,11795418,1904
FBgn0004381,Klp68D,3L,11795614,11798875,3261
FBgn0036213,RpL10Ab,3L,11822851,11824211,1360
FBgn0036214,CG7264,3L,11829030,11830844,1814
FBgn0036218,Sprn,3L,11879115,11881182,2067
FBgn0036224,Rpt4R,3L,11941912,11943485,1573
FBgn0036226,CG7252,3L,11947675,11949248,1573
FBgn0036232,CG14125,3L,11974905,11975810,905
FBgn0036235,CG6938,3L,11984906,11990505,5599
FBgn0036236,CG6931,3L,11990736,11992000,1264
FBgn0036240,CG6928,3L,12003155,12008051,4896
FBgn0036242,CG6793,3L,12042387,12044217,1830
FBgn0041096,rols,3L,12008225,12064859,56634
FBgn0036239,Pop2,3L,11998398,12002915,4517
FBgn0026432,Grip163,3L,11993274,11998138,4864
FBgn0036237,viaf,3L,11991853,11993179,1326
FBgn0028573,prc,3L,11958872,11966131,7259
FBgn0036225,CG5883,3L,11943640,11944852,1212
FBgn0036222,SdhAL,3L,11922610,11924757,2147
FBgn0036220,CG5897,3L,11887259,11889010,1751
FBgn0036217,CG5906,3L,11870457,11871305,848
FBgn0000404,CycA,3L,11826719,11833578,6859
FBgn0052095,CG32095,3L,11824207,11825732,1525
FBgn0036211,CG5946,3L,11816695,11822275,5580
FBgn0036212,CG11597,3L,11820338,11822275,1937
FBgn0036208,Gcat,3L,11798948,11800861,1913
FBgn0036206,twy,3L,11790212,11793283,3071
FBgn0015278,Pi3K68D,3L,11774650,11790013,15363
FBgn0036204,Tim13,3L,11774060,11774501,441
FBgn0036168,CG7512,3L,11513705,11518904,5199
FBgn0036173,CG7394,3L,11561996,11564312,2316
FBgn0036179,CG7368,3L,11597202,11605374,8172
FBgn0036184,PCID2,3L,11626441,11627715,1274
FBgn0042138,Apt1,3L,11628037,11630749,2712
FBgn0052091,CG32091,3L,11631392,11642902,11510
FBgn0036188,Polr3H,3L,11648756,11650499,1743
FBgn0015828,TfIIEalpha,3L,11682038,11683805,1767
FBgn0036191,Sugb,3L,11683980,11690155,6175
FBgn0036193,CG14135,3L,11691571,11692757,1186
FBgn0036199,Bmcp,3L,11720934,11728118,7184
FBgn0036202,loaf,3L,11733589,11766182,32593
FBgn0040817,CG14132,3L,11712229,11715285,3056
FBgn0036198,crim,3L,11710507,11711386,879
FBgn0036196,CG11658,3L,11699496,11708553,9057
FBgn0036195,Dnai2,3L,11697126,11699263,2137
FBgn0036194,Dph1,3L,11693879,11696963,3084
FBgn0036192,Pldn,3L,11689631,11691399,1768
FBgn0052085,CG32085,3L,11650517,11680344,29827
FBgn0036187,RIOK1,3L,11646234,11648474,2240
FBgn0036186,CG6071,3L,11642906,11646033,3127
FBgn0036183,CG6083,3L,11624528,11626125,1597
FBgn0036181,Muc68Ca,3L,11610578,11620101,9523
FBgn0036178,CG14137,3L,11599505,11600065,560
FBgn0003292,rt,3L,11584122,11587770,3648
FBgn0003378,Sgs8,3L,11508967,11509394,427
FBgn0036142,Adck5,3L,11169817,11172411,2594
FBgn0036143,CG14142,3L,11173514,11176892,3378
FBgn0036145,CG7607,3L,11199620,11200587,967
FBgn0036146,nkt,3L,11201351,11202158,807
FBgn0064766,CG7600,3L,11210786,11214097,3311
FBgn0041094,scyl,3L,11252307,11256172,3865
FBgn0036153,CG7573,3L,11311747,11313397,1650
FBgn0036157,CG7560,3L,11425158,11426395,1237
FBgn0036159,CG7557,3L,11445161,11446579,1418
FBgn0036162,Fum3,3L,11463570,11465864,2294
FBgn0036155,CG6163,3L,11361986,11364885,2899
FBgn0036152,Dyro,3L,11287936,11295919,7983
FBgn0036150,Ir68a,3L,11232972,11236218,3246
FBgn0061469,Ube3a,3L,11206422,11210583,4161
FBgn0036147,Plod,3L,11198166,11206016,7850
FBgn0036110,Cpr67Fb,3L,10894173,10894693,520
FBgn0029172,Fad2,3L,11023535,11024846,1311
FBgn0052081,CG32081,3L,11027579,11029444,1865
FBgn0036116,CG7888,3L,11054035,11059659,5624
FBgn0036118,Blos2,3L,11061571,11062215,644
FBgn0025355,SuUR,3L,11064991,11069025,4034
FBgn0036124,Noc1,3L,11074769,11078736,3967
FBgn0036133,emei,3L,11109690,11112117,2427
FBgn0036135,mRpL2,3L,11120847,11122041,1194
FBgn0014368,nol,3L,11130835,11131402,567
FBgn0052082,IRSp53,3L,11136049,11163984,27935
FBgn0052076,Alg10,3L,11164971,11166620,1649
FBgn0036141,wls,3L,11166620,11169625,3005
FBgn0036139,CG6216,3L,11149578,11150785,1207
FBgn0052074,CG32074,3L,11131883,11132322,439
FBgn0036136,Ufd1,3L,11121966,11123216,1250
FBgn0036134,FoxK,3L,11114169,11120783,6614
FBgn0003462,Sod1,3L,11112281,11113740,1459
FBgn0036126,Irbp18,3L,11097446,11098186,740
FBgn0020412,JIL-1,3L,11078752,11093193,14441
FBgn0010741,Pfdn2,3L,11073292,11074388,1096
FBgn0036121,CG6310,3L,11069043,11069864,821
FBgn0052075,CG32075,3L,11062726,11064941,2215
FBgn0052069,CG32069,3L,11062131,11062614,483
FBgn0036117,CG6321,3L,11059437,11061224,1787
FBgn0013469,klu,3L,10981171,11009188,28017
FBgn0036111,Aps,3L,10894776,10899123,4347
FBgn0001179,hay,3L,10631079,10633969,2890
FBgn0036090,Cnep1r2,3L,10638146,10639678,1532
FBgn0036091,CG18628,3L,10639740,10640136,396
FBgn0036093,CG14154,3L,10641889,10643009,1120
FBgn0036094,CG14153,3L,10643528,10644615,1087
FBgn0036096,CG8003,3L,10661475,10663157,1682
FBgn0052068,Adi1,3L,10663376,10664435,1059
FBgn0010762,simj,3L,10664739,10690734,25995
FBgn0036099,oya,3L,10691024,10692598,1574
FBgn0026160,tna,3L,10835528,10876496,40968
FBgn0036105,Blos4,3L,10879085,10880188,1103
FBgn0036107,galla-2,3L,10882890,10883573,683
FBgn0027615,OXA1L,3L,10884261,10886471,2210
FBgn0036106,CG6409,3L,10880699,10882386,1687
FBgn0036104,CG6418,3L,10876315,10879037,2722
FBgn0047038,ND-13B,3L,10693184,10694108,924
FBgn0052066,CG32066,3L,10640286,10661013,20727
FBgn0000629,E(z),3L,10634575,10638130,3555
FBgn0036082,CG12362,3L,10412818,10414774,1956
FBgn0045770,S-Lap3,3L,10465187,10468974,3787
FBgn0052064,S-Lap4,3L,10490861,10492934,2073
FBgn0052062,Rbfox1,3L,10481412,10594012,112600
FBgn0011802,Gem3,3L,10459081,10463101,4020
FBgn0052058,Ir67c,3L,10432384,10434105,1721
FBgn0036083,Ir67b,3L,10429689,10431983,2294
FBgn0036080,Or67d,3L,10273204,10274624,1420
FBgn0011569,can,3L,10263909,10267111,3202
FBgn0052055,CG32055,3L,10218504,10220164,1660
FBgn0000451,ect,3L,10190276,10201837,11561
FBgn0052057,dpr10,3L,10147454,10186108,38654
FBgn0036072,CG6628,3L,10165809,10167023,1214
FBgn0036043,Ae2,3L,9763544,9786466,22922
FBgn0044051,Ilp1,3L,9798420,9799050,630
FBgn0036046,Ilp2,3L,9799698,9800440,742
FBgn0044328,CG32052,3L,9787046,9808713,21667
FBgn0027567,Ciz1,3L,9864639,9870674,6035
FBgn0025866,CalpB,3L,9888762,9893319,4557
FBgn0036059,nudE,3L,9899241,9903031,3790
FBgn0026404,Dronc,3L,9968479,9971002,2523
FBgn0040823,dpr6,3L,9974651,10139360,164709
FBgn0036063,CG6674,3L,9971151,9972054,903
FBgn0036062,CG6685,3L,9966603,9968317,1714
FBgn0036058,CG6707,3L,9894807,9898575,3768
FBgn0036057,Hez,3L,9893188,9894743,1555
FBgn0036056,CG6709,3L,9893188,9894743,1555
FBgn0011836,Taf2,3L,9884411,9888683,4272
FBgn0036053,iPLA2-VIA,3L,9860217,9864349,4132
FBgn0036052,CG10809,3L,9857383,9859889,2506
FBgn0004390,RasGAP1,3L,9839093,9855285,16192
FBgn0015618,Cdk8,3L,9837080,9838670,1590
FBgn0028429,I-2,3L,9834367,9836805,2438
FBgn0044048,Ilp5,3L,9823349,9823897,548
FBgn0044050,Ilp3,3L,9801298,9802120,822
FBgn0036044,Zasp67,3L,9787933,9797687,9754
FBgn0036014,CG3222,3L,9598988,9600341,1353
FBgn0036016,CG3306,3L,9601523,9602548,1025
FBgn0036018,CG3335,3L,9624237,9627321,3084
FBgn0036020,Cyp40,3L,9628676,9631795,3119
FBgn0036022,CG8329,3L,9638112,9639021,909
FBgn0036023,CG18179,3L,9639271,9640140,869
FBgn0036024,CG18180,3L,9641013,9641913,900
FBgn0036028,Mpped,3L,9679201,9681060,1859
FBgn0036029,CG16719,3L,9685171,9686250,1079
FBgn0015321,Ubc4,3L,9698336,9700481,2145
FBgn0036032,CG16711,3L,9704331,9710329,5998
FBgn0045823,vsg,3L,9714324,9717716,3392
FBgn0036036,CG14174,3L,9719328,9720464,1136
FBgn0036038,defl,3L,9723423,9726706,3283
FBgn0019644,ATPsynB,3L,9729999,9731224,1225
FBgn0036040,CG6749,3L,9731238,9733807,2569
FBgn0036035,CG18178,3L,9717786,9719144,1358
FBgn0040475,SH3PX1,3L,9710422,9713827,3405
FBgn0036031,CG6761,3L,9700517,9703595,3078
FBgn0036030,Prps,3L,9683579,9696700,13121
FBgn0016081,fry,3L,9631834,9679103,47269
FBgn0036015,CG3088,3L,9600490,9601325,835
FBgn0010408,RpS9,3L,9509793,9511531,1738
FBgn0036008,CG3408,3L,9506818,9509583,2765
FBgn0036007,path,3L,9494555,9505328,10773
FBgn0035969,CG4476,3L,9211880,9215256,3376
FBgn0035975,PGRP-LA,3L,9334332,9338336,4004
FBgn0035977,PGRP-LF,3L,9349609,9351489,1880
FBgn0052040,CG32040,3L,9354033,9355457,1424
FBgn0052039,Svip,3L,9358999,9359996,997
FBgn0035980,mRRF1,3L,9364350,9365240,890
FBgn0035982,CG4461,3L,9375430,9376293,863
FBgn0001224,Hsp23,3L,9381882,9382765,883
FBgn0001226,Hsp27,3L,9384063,9385694,1631
FBgn0035985,Cpr67B,3L,9404797,9406174,1377
FBgn0023129,aay,3L,9423253,9424781,1528
FBgn0015296,Shc,3L,9427010,9428671,1661
FBgn0040305,MTF-1,3L,9430312,9439490,9178
FBgn0035995,CG3529,3L,9446864,9450785,3921
FBgn0035999,CG3552,3L,9456318,9459370,3052
FBgn0036004,Jarid2,3L,9477038,9486530,9492
FBgn0052037,CG32037,3L,9489502,9492215,2713
FBgn0052036,CG32036,3L,9488050,9489233,1183
FBgn0036005,pall,3L,9486448,9487790,1342
FBgn0011327,Uch-L5,3L,9475493,9476965,1472
FBgn0036000,CG3434,3L,9459369,9460799,1430
FBgn0035998,CG3437,3L,9456342,9457669,1327
FBgn0035997,phol,3L,9452803,9456281,3478
FBgn0035996,CG3448,3L,9450545,9451572,1027
FBgn0005533,RpS17,3L,9428795,9429821,1026
FBgn0035989,Atat,3L,9413596,9426758,13162
FBgn0035988,CG3982,3L,9415755,9417388,1633
FBgn0035986,CG4022,3L,9406179,9410832,4653
FBgn0015218,eIF4E1,3L,9399618,9402460,2842
FBgn0035983,CG4080,3L,9386827,9399227,12400
FBgn0001227,Hsp67Ba,3L,9377802,9379534,1732
FBgn0001225,Hsp26,3L,9376418,9377427,1009
FBgn0001229,Hsp67Bc,3L,9371511,9372497,986
FBgn0011769,Fdx1,3L,9370195,9371238,1043
FBgn0004379,Klp67A,3L,9362636,9367046,4410
FBgn0035968,Slc45-1,3L,9203065,9208853,5788
FBgn0035993,Nf-YA,3L,9440056,9442267,2211
FBgn0035936,Tsp66E,3L,8912499,8932065,19566
FBgn0040321,GNBP3,3L,8955021,8956551,1530
FBgn0011787,mRpL12,3L,8956791,8957584,793
FBgn0035941,CG13313,3L,8958857,8960921,2064
FBgn0035944,CG5021,3L,8966829,8968171,1342
FBgn0035947,Srp68,3L,8975046,8977401,2355
FBgn0035949,CG13314,3L,8981795,8983212,1417
FBgn0035951,CG5068,3L,8986710,8989135,2425
FBgn0035953,CG5087,3L,8998184,9002566,4382
FBgn0035954,Doc3,3L,9005196,9007249,2053
FBgn0028789,Doc1,3L,9041375,9045042,3667
FBgn0035957,Argk2,3L,9047439,9048724,1285
FBgn0035960,CG4942,3L,9073105,9074467,1362
FBgn0023479,teq,3L,9074643,9092131,17488
FBgn0043806,CG32032,3L,9093053,9094856,1803
FBgn0040827,CG13315,3L,9096877,9097494,617
FBgn0004244,Rdl,3L,9145838,9182149,36311
FBgn0035965,Use1,3L,9135709,9137181,1472
FBgn0011206,bol,3L,9097629,9134405,36776
FBgn0035959,CG4911,3L,9067195,9072731,5536
FBgn0000116,Argk1,3L,9048781,9066027,17246
FBgn0035955,CG5194,3L,9008624,9009838,1214
FBgn0016070,smg,3L,8990317,8997989,7672
FBgn0035952,CG5280,3L,8989069,8990228,1159
FBgn0035948,CG5644,3L,8977395,8979880,2485
FBgn0035943,CG5653,3L,8964912,8966374,1462
FBgn0035942,ValRS-m,3L,8961274,8964769,3495
FBgn0052029,Cpr66D,3L,8640439,8643584,3145
FBgn0035922,Pex7,3L,8647145,8651011,3866
FBgn0035923,CG6511,3L,8721324,8726108,4784
FBgn0000357,Cp18,3L,8726791,8727613,822
FBgn0000358,Cp19,3L,8729865,8730604,739
FBgn0052026,CG32026,3L,8836462,8838843,2381
FBgn0020633,Mcm7,3L,8891596,8894310,2714
FBgn0035934,TrpA1,3L,8894404,8905200,10796
FBgn0035928,CG13310,3L,8798730,8800532,1802
FBgn0040828,CG13306,3L,8749139,8749726,587
FBgn0003149,Prm,3L,8732858,8745310,12452
FBgn0052022,CG32022,3L,8720280,8721272,992
FBgn0011509,SrpRbeta,3L,8718949,8720225,1276
FBgn0000121,Arr2,3L,8647261,8648936,1675
FBgn0035921,CG13305,3L,8644916,8646822,1906
FBgn0035875,Cpr66Cb,3L,8336672,8338595,1923
FBgn0035876,Pex2,3L,8339051,8340276,1225
FBgn0011762,Prim1,3L,8340314,8344404,4090
FBgn0035877,CG7083,3L,8340785,8342876,2091
FBgn0001253,ImpE1,3L,8372405,8391171,18766
FBgn0035888,CG7120,3L,8396000,8402295,6295
FBgn0035890,CG13667,3L,8405454,8407354,1900
FBgn0010431,mtrm,3L,8413012,8414103,1091
FBgn0020224,Cbl,3L,8424954,8432246,7292
FBgn0010825,Gug,3L,8449922,8472669,22747
FBgn0035901,Pus7,3L,8510003,8513007,3004
FBgn0035903,CG6765,3L,8512767,8518738,5971
FBgn0035904,GstO3,3L,8518885,8520295,1410
FBgn0024236,foi,3L,8525244,8534503,9259
FBgn0035909,ergic53,3L,8534977,8538013,3036
FBgn0260442,rhea,3L,8545001,8574409,29408
FBgn0060292,snoRNA:U49:66Da,3L,8601473,8601552,79
FBgn0060291,snoRNA:U49:66Db,3L,8601948,8602031,83
FBgn0035914,CG6282,3L,8604657,8617074,12417
FBgn0035915,S-Lap1,3L,8617235,8619474,2239
FBgn0052351,S-Lap2,3L,8619888,8622091,2203
FBgn0035918,Cdc6,3L,8631509,8634069,2560
FBgn0035916,GAPsec,3L,8622039,8623901,1862
FBgn0017429,CG5989,3L,8602411,8604149,1738
FBgn0017430,Nelf-E,3L,8599442,8600879,1437
FBgn0035911,CG6638,3L,8574407,8576078,1671
FBgn0035907,GstO1,3L,8523742,8524866,1124
FBgn0035906,GstO2,3L,8521429,8523501,2072
FBgn0035902,CG6683,3L,8513874,8514921,1047
FBgn0035900,ZC3H3,3L,8507469,8509763,2294
FBgn0035896,CG6983,3L,8443042,8449377,6335
FBgn0052354,CG32354,3L,8415857,8422205,6348
FBgn0035889,mkg-p,3L,8402168,8405277,3109
FBgn0035887,Jon66Cii,3L,8392820,8393649,829
FBgn0001248,Idh,3L,8356404,8360906,4502
FBgn0035878,CG7182,3L,8344421,8346382,1961
FBgn0053057,Tpt,3L,8402168,8405277,3109
FBgn0028379,fan,3L,8109132,8110043,911
FBgn0027549,Nulp1,3L,8110368,8113406,3038
FBgn0026252,msk,3L,8116179,8121579,5400
FBgn0035838,ldbr,3L,8121827,8123615,1788
FBgn0010350,Cds,3L,8127762,8131675,3913
FBgn0002899,mus301,3L,8137808,8142014,4206
FBgn0035848,Uxs,3L,8180923,8183369,2446
FBgn0035850,Atg18a,3L,8186857,8191118,4261
FBgn0035851,MED24,3L,8191270,8196573,5303
FBgn0035854,Dhps,3L,8198207,8199491,1284
FBgn0035856,CG13679,3L,8202792,8203345,553
FBgn0035857,CG8006,3L,8211890,8213622,1732
FBgn0040832,CG8012,3L,8215280,8216198,918
FBgn0035859,CG13678,3L,8222141,8222953,812
FBgn0015793,Rab19,3L,8297018,8298506,1488
FBgn0035867,CG13671,3L,8300064,8302341,2277
FBgn0035873,CG13670,3L,8320763,8322280,1517
FBgn0035872,Cpsf6,3L,8310493,8315502,5009
FBgn0035871,BI-1,3L,8307145,8308941,1796
FBgn0035870,Gr66a,3L,8305336,8306980,1644
FBgn0035868,CG7194,3L,8302364,8304059,1695
FBgn0035866,Arl5,3L,8298501,8299839,1338
FBgn0035865,CG7201,3L,8290286,8295327,5041
FBgn0027569,cert,3L,8282528,8289870,7342
FBgn0035861,CG7213,3L,8231814,8240601,8787
FBgn0035858,CG13674,3L,8218232,8218983,751
FBgn0052364,tut,3L,8209577,8210743,1166
FBgn0035855,CG7366,3L,8201078,8202417,1339
FBgn0035853,UbcE2M,3L,8195847,8197987,2140
FBgn0035852,CG7387,3L,8191522,8193116,1594
FBgn0035849,ERR,3L,8183361,8186671,3310
FBgn0020392,Nmt,3L,8176135,8178429,2294
FBgn0040290,RecQ4,3L,8170640,8175978,5338
FBgn0035844,CG13676,3L,8141868,8151813,9945
FBgn0035842,Setx,3L,8131429,8137498,6069
FBgn0029113,Uba2,3L,8125327,8127818,2491
FBgn0042112,mRpL36,3L,8124584,8125132,548
FBgn0035839,CG7550,3L,8123612,8124531,919
FBgn0035833,CG7565,3L,8087635,8091786,4151
FBgn0026263,bip1,3L,8054333,8058713,4380
FBgn0052365,CG32365,3L,7869042,7894814,25772
FBgn0035823,eIF4E5,3L,7894880,7896009,1129
FBgn0035824,CG8281,3L,7912463,7913763,1300
FBgn0052368,lncRNA:CR32368,3L,7915437,7915846,409
FBgn0035827,Srp9,3L,7936373,7937258,885
FBgn0041156,exex,3L,7948186,7951563,3377
FBgn0035830,CG8209,3L,7976406,7977849,1443
FBgn0011817,nmo,3L,7979046,8054147,75101
FBgn0035831,Pop4,3L,7977805,7978650,845
FBgn0035829,HP4,3L,7975438,7976154,716
FBgn0027554,CG8042,3L,7972449,7974991,2542
FBgn0024187,syd,3L,7916650,7936120,19470
FBgn0035825,Tmem43,3L,7913664,7915120,1456
FBgn0003041,pbl,3L,7896109,7911954,15845
FBgn0016694,Pdp1,3L,7811458,7867369,55911
FBgn0052369,CG32369,3L,7777105,7809825,32720
FBgn0052371,CG32371,3L,7767269,7768352,1083
FBgn0035793,CG7546,3L,7510986,7517316,6330
FBgn0028582,lqf,3L,7528780,7540012,11232
FBgn0035798,frac,3L,7562610,7569499,6889
FBgn0035799,mmm,3L,7583454,7587248,3794
FBgn0052373,CG32373,3L,7650548,7759123,108575
FBgn0035806,PGRP-SD,3L,7651180,7651900,720
FBgn0035811,Mcad,3L,7719350,7721472,2122
FBgn0035816,CG13685,3L,7747344,7750552,3208
FBgn0035817,CG7409,3L,7754409,7755168,759
FBgn0035815,Snmp2,3L,7733250,7743041,9791
FBgn0035813,CG8492,3L,7727804,7732191,4387
FBgn0035812,CG7457,3L,7719899,7726473,6574
FBgn0035807,CG7492,3L,7651866,7654752,2886
FBgn0035805,CG7506,3L,7640798,7641648,850
FBgn0053276,Urm1,3L,7639811,7640446,635
FBgn0035800,t-Grip84,3L,7588608,7590998,2390
FBgn0035797,CG14837,3L,7555780,7560037,4257
FBgn0035792,CG7548,3L,7505540,7506217,677
FBgn0035791,CG8539,3L,7497211,7498831,1620
FBgn0015033,Cyp4d8,3L,7493557,7496197,2640
FBgn0024542,Neos,3L,7241628,7243139,1511
FBgn0016036,mei-P22,3L,7244388,7245383,995
FBgn0035760,CG8607,3L,7320068,7321211,1143
FBgn0035762,Rint1,3L,7323619,7326255,2636
FBgn0002909,mus312,3L,7329132,7333471,4339
FBgn0019662,qm,3L,7348313,7353622,5309
FBgn0035771,Sec63,3L,7360561,7364366,3805
FBgn0082598,akirin,3L,7369843,7373711,3868
FBgn0016983,smid,3L,7381614,7385637,4023
FBgn0035777,CG8563,3L,7390742,7396013,5271
FBgn0053278,CG33278,3L,7450853,7452159,1306
FBgn0035785,ppk26,3L,7456149,7458608,2459
FBgn0014011,Rac2,3L,7432762,7435190,2428
FBgn0035781,CG8560,3L,7402332,7404181,1849
FBgn0035776,CG8564,3L,7385648,7387914,2266
FBgn0052380,SMSr,3L,7374050,7381474,7424
FBgn0035772,Sh3beta,3L,7364584,7369260,4676
FBgn0035770,pst,3L,7357275,7360263,2988
FBgn0035769,CTCF,3L,7353578,7356713,3135
FBgn0015298,Srp19,3L,7347310,7348034,724
FBgn0035768,CG14834,3L,7345698,7347123,1425
FBgn0035767,Cln7,3L,7341884,7345183,3299
FBgn0035763,mrva,3L,7326273,7328842,2569
FBgn0035761,RhoGEF4,3L,7321099,7323411,2312
FBgn0035756,unc-13-4A,3L,7266192,7312896,46704
FBgn0035755,CG14830,3L,7250718,7263920,13202
FBgn0035754,MED4,3L,7249529,7250527,998
FBgn0012058,Cdc27,3L,7245481,7249340,3859
FBgn0028648,mRpL50,3L,7243080,7243933,853
FBgn0035753,RpL18,3L,7240203,7241351,1148
FBgn0035751,CG14829,3L,7236800,7238122,1322
FBgn0035718,CG14820,3L,6932926,6934824,1898
FBgn0035719,tow,3L,6942856,6949313,6457
FBgn0035721,CG9948,3L,6955991,6957440,1449
FBgn0029117,Surf1,3L,6958346,6959586,1240
FBgn0035726,CG9953,3L,6969658,6971666,2008
FBgn0035734,CG14823,3L,7066314,7069463,3149
FBgn0035737,Cpr65Ec,3L,7093204,7093841,637
FBgn0035741,BBS1,3L,7125905,7128118,2213
FBgn0035743,Acbp6,3L,7128903,7129673,770
FBgn0010387,Acbp2,3L,7131863,7133463,1600
FBgn0023001,melt,3L,7134516,7143074,8558
FBgn0040837,CG8620,3L,7158099,7158874,775
FBgn0002775,msl-3,3L,7123213,7125533,2320
FBgn0052391,CG32391,3L,7068211,7069199,988
FBgn0035733,CG8641,3L,7058930,7077462,18532
FBgn0001104,Galphai,3L,6972750,6980044,7294
FBgn0035727,CG10063,3L,6971579,6972467,888
FBgn0035725,Mis12,3L,6968035,6969048,1013
FBgn0035724,CG10064,3L,6965260,6967897,2637
FBgn0035722,Uqcc1,3L,6956946,6958108,1162
FBgn0035720,CG10077,3L,6949491,6955904,6413
FBgn0035711,CG8519,3L,6704860,6709000,4140
FBgn0035714,Sbds,3L,6752913,6754029,1116
FBgn0041194,Prat2,3L,6911999,6914876,2877
FBgn0052392,Rsph3,3L,6756629,6763246,6617
FBgn0035715,Ist1,3L,6754017,6756497,2480
FBgn0035713,velo,3L,6744426,6752752,8326
FBgn0005626,ple,3L,6713356,6719525,6169
FBgn0035710,SP1173,3L,6689327,6703521,14194
FBgn0035709,eIF4E4,3L,6664224,6665641,1417
FBgn0035703,Bulli,3L,6488681,6491210,2529
FBgn0020251,sfl,3L,6495680,6550104,54424
FBgn0052396,betaTub65B,3L,6530729,6532429,1700
FBgn0042185,MCU,3L,6550738,6593940,43202
FBgn0035708,axed,3L,6609325,6619113,9788
FBgn0004619,GluRIA,3L,6624032,6635059,11027
FBgn0035704,Vps8,3L,6491230,6495297,4067
FBgn0035702,CG10147,3L,6486167,6488424,2257
FBgn0020642,Lcp65Ac,3L,6144819,6145393,574
FBgn0035689,CG7376,3L,6174248,6178941,4693
FBgn0035691,CG7386,3L,6189745,6192049,2304
FBgn0024921,Tnpo,3L,6193480,6200385,6905
FBgn0035693,CG8219,3L,6200473,6203776,3303
FBgn0035699,CG13300,3L,6329324,6352390,23066
FBgn0001258,Ldh,3L,6259105,6262694,3589
FBgn0035696,Best2,3L,6245933,6256665,10732
FBgn0004513,Mdr65,3L,6240500,6245746,5246
FBgn0035695,CG10226,3L,6234323,6240068,5745
FBgn0035694,CG13299,3L,6231805,6232361,556
FBgn0002526,LanA,3L,6203831,6218022,14191
FBgn0035692,Sf3b6,3L,6192124,6193179,1055
FBgn0022935,D19A,3L,6185830,6189123,3293
FBgn0022699,D19B,3L,6182176,6184920,2744
FBgn0035690,CG10274,3L,6178677,6181829,3152
FBgn0035688,fmt,3L,6164916,6173880,8964
FBgn0035685,CG13297,3L,6156592,6157377,785
FBgn0020765,Acp65Aa,3L,6152050,6152745,695
FBgn0035643,CG13287,3L,5882304,5884090,1786
FBgn0052409,CG32409,3L,5899528,5900936,1408
FBgn0035648,CG13288,3L,5907381,5917540,10159
FBgn0052407,CG32407,3L,5922055,5923567,1512
FBgn0052406,PVRAP,3L,5997208,6026317,29109
FBgn0040060,yip7,3L,6035216,6036175,959
FBgn0035663,CG6462,3L,6037111,6038188,1077
FBgn0035665,Jon65Aiii,3L,6050757,6051690,933
FBgn0028980,tant,3L,6055136,6057002,1866
FBgn0035669,CG6592,3L,6059658,6061378,1720
FBgn0035673,CG6602,3L,6072139,6073539,1400
FBgn0035675,CG6610,3L,6075536,6076258,722
FBgn0035676,ssp6,3L,6076722,6082491,5769
FBgn0035677,CG13293,3L,6082883,6092188,9305
FBgn0061492,loj,3L,6094987,6096517,1530
FBgn0005658,Ets65A,3L,6097617,6123913,26296
FBgn0020638,Lcp65Ag1,3L,6134697,6135274,577
FBgn0020637,Lcp65Ag2,3L,6132990,6133593,603
FBgn0042119,Cpr65Au,3L,6131242,6132109,867
FBgn0035679,CG10467,3L,6093204,6094747,1543
FBgn0035678,CG10469,3L,6092188,6093313,1125
FBgn0035674,CG13295,3L,6073490,6075245,1755
FBgn0035670,CG10472,3L,6061372,6062910,1538
FBgn0035667,Jon65Ai,3L,6053493,6054443,950
FBgn0035661,CG10477,3L,6033199,6034611,1412
FBgn0035656,CG10479,3L,5967545,5976007,8462
FBgn0002638,Rcc1,3L,5930262,5932773,2511
FBgn0035649,PXo,3L,5917905,5921316,3411
FBgn0052412,QC,3L,5900835,5902456,1621
FBgn0035644,PolE2,3L,5895691,5897435,1744
FBgn0029121,Sras,3L,5563774,5565103,1329
FBgn0040239,bc10,3L,5565231,5566765,1534
FBgn0035617,l(3)psg2,3L,5583669,5590390,6721
FBgn0035620,Alp9,3L,5595542,5597422,1880
FBgn0035623,mthl2,3L,5604790,5607190,2400
FBgn0035625,Blimp-1,3L,5630983,5652094,21111
FBgn0035626,lin-28,3L,5654681,5657384,2703
FBgn0016756,Usp47,3L,5752973,5761886,8913
FBgn0035631,Txl,3L,5765846,5767084,1238
FBgn0035639,kri,3L,5810973,5812228,1255
FBgn0035640,mad2,3L,5812135,5813093,958
FBgn0035638,Tektin-C,3L,5794405,5796543,2138
FBgn0035636,Cralbp,3L,5783215,5786718,3503
FBgn0040298,Myt1,3L,5777476,5779591,2115
FBgn0052418,vito,3L,5776324,5777333,1009
FBgn0035632,Ppat-Dpck,3L,5767017,5768794,1777
FBgn0035630,CG10576,3L,5761963,5765702,3739
FBgn0035627,Sse,3L,5659700,5662247,2547
FBgn0035624,Eaf6,3L,5607162,5608300,1138
FBgn0035622,TM9SF3,3L,5601096,5603979,2883
FBgn0035619,Alp10,3L,5592741,5595272,2531
FBgn0015766,Msr-110,3L,5566919,5577348,10429
FBgn0029118,ScsbetaG,3L,5561701,5563691,1990
FBgn0035612,frm,3L,5538411,5551159,12748
FBgn0035611,CG13285,3L,5533968,5535759,1791
FBgn0035600,Cyt-c1,3L,5360211,5362798,2587
FBgn0035610,Lkr,3L,5512421,5529341,16920
FBgn0035608,blanks,3L,5497523,5498958,1435
FBgn0035603,Pfdn4,3L,5367341,5368008,667
FBgn0035601,Uev1A,3L,5362884,5366225,3341
FBgn0004380,Klp64D,3L,5356864,5359392,2528
FBgn0016031,lama,3L,5343619,5355923,12304
FBgn0040842,CG15212,3L,5131545,5132127,582
FBgn0035593,Yod1,3L,5133871,5135670,1799
FBgn0035591,CG4611,3L,5136376,5138679,2303
FBgn0035589,CHMP2B,3L,5139619,5140473,854
FBgn0035587,Gdap1,3L,5141953,5144317,2364
FBgn0028962,AlaRS-m,3L,5146098,5149852,3754
FBgn0010747,Srp54k,3L,5152678,5154777,2099
FBgn0035598,CG4669,3L,5234483,5236631,2148
FBgn0035586,Fitm,3L,5144082,5146063,1981
FBgn0035588,Dhrs4,3L,5140440,5141646,1206
FBgn0035590,Tcs5,3L,5138652,5139395,743
FBgn0035592,CG10674,3L,5135748,5136292,544
FBgn0040843,CG15213,3L,5132796,5133220,424
FBgn0052523,CG32523,X,21217878,21218835,957
FBgn0031169,CG1494,X,21285301,21292458,7157
FBgn0020369,Rpt6,X,21316052,21317663,1611
FBgn0031174,CG1486,X,21324046,21328150,4104
FBgn0000709,fliI,X,21339741,21345088,5347
FBgn0015379,dod,X,21345358,21346858,1500
FBgn0011710,Septin1,X,21358286,21361688,3402
FBgn0003423,slgA,X,21374002,21385159,11157
FBgn0020272,mst,X,21388977,21391533,2556
FBgn0031182,Cyp6t1,X,21517434,21519218,1784
FBgn0031178,CG10918,X,21428614,21429256,642
FBgn0031176,whe,X,21402339,21402772,433
FBgn0028583,lcs,X,21396727,21397316,589
FBgn0001565,Ddx56,X,21385518,21387946,2428
FBgn0025882,snoRNA:MeU6-A47,X,21386845,21386935,90
FBgn0015527,peng,X,21346503,21349843,3340
FBgn0015558,tty,X,21328613,21339676,11063
FBgn0029067,Dd,X,21319791,21324009,4218
FBgn0031171,CG1801,X,21307586,21317522,9936
FBgn0031170,Abca3,X,21292308,21306665,14357
FBgn0052521,Mnr,X,21205310,21281171,75861
FBgn0031168,CG1722,X,21249976,21251148,1172
FBgn0052518,tRNA:Ile-AAT-2-1Psi,X,21231325,21231399,74
FBgn0031145,Ntf-2,X,21035469,21041467,5998
FBgn0025814,Mgstl,X,21042125,21044107,1982
FBgn0031148,Cbs,X,21045138,21049096,3958
FBgn0031150,bves,X,21053963,21082391,28428
FBgn0031161,CG15445,X,21117159,21120444,3285
FBgn0031164,CG1724,X,21202499,21203341,842
FBgn0052511,CR32511,X,21156259,21156621,362
FBgn0031157,CG1503,X,21104695,21106369,1674
FBgn0031155,CG15446,X,21095680,21102206,6526
FBgn0052512,CG32512,X,21062277,21067540,5263
FBgn0031149,Stt3A,X,21049885,21053937,4052
FBgn0031146,CG15449,X,21039514,21040605,1091
FBgn0031144,CG1529,X,21028652,21031950,3298
FBgn0031143,CG1532,X,21026125,21028361,2236
FBgn0031142,r-cup,X,21023390,21025888,2498
FBgn0031134,CG1314,X,20867989,20869397,1408
FBgn0031129,CG1324,X,20734455,20735960,1505
FBgn0027334,l(1)G0004,X,20391447,20392401,954
FBgn0031107,HERC2,X,20394395,20412247,17852
FBgn0031109,Obp19a,X,20415744,20416521,777
FBgn0031110,Obp19b,X,20416733,20417812,1079
FBgn0011280,Obp19d,X,20419613,20420979,1366
FBgn0031114,cactin,X,20424069,20426402,2333
FBgn0002641,mal,X,20429675,20433210,3535
FBgn0031116,CG1695,X,20433950,20445599,11649
FBgn0052506,tbc,X,20449331,20467065,17734
FBgn0031117,GstT3,X,20467455,20469796,2341
FBgn0040649,CG15461,X,20486180,20486588,408
FBgn0031119,CG1812,X,20511544,20515828,4284
FBgn0026323,Tak1,X,20515908,20524928,9020
FBgn0031118,RhoGAP19D,X,20469955,20510694,40739
FBgn0040650,CG15456,X,20426431,20427042,611
FBgn0023177,Pp4-19C,X,20421087,20424002,2915
FBgn0031111,Obp19c,X,20417921,20418964,1043
FBgn0031108,CG15459,X,20412341,20413581,1240
FBgn0031106,Syx16,X,20392334,20393751,1417
FBgn0031104,jb,X,20390096,20390806,710
FBgn0031100,CG1504,X,20302015,20330372,28357
FBgn0031183,CG14621,X,22444227,22447808,3581
FBgn0014395,tilB,X,22449737,22451463,1726
FBgn0031187,Usp2,X,22455803,22470146,14343
FBgn0031189,CG14618,X,22473698,22474998,1300
FBgn0027279,l(1)G0196,X,22487180,22508129,20949
FBgn0052499,Cda4,X,22583634,22632710,49076
FBgn0031190,CG12576,X,22474851,22482357,7506
FBgn0031188,CG14613,X,22469981,22472021,2040
FBgn0031184,CG14615,X,22447183,22449491,2308
FBgn0031620,CG11929,2L,4682677,4687232,4555
FBgn0031628,CG3294,2L,4794549,4796581,2032
FBgn0031630,CG15629,2L,4813009,4815891,2882
FBgn0031632,CG15628,2L,4821774,4828945,7171
FBgn0031636,CG12194,2L,4838347,4841465,3118
FBgn0031638,CG11927,2L,4847766,4849499,1733
FBgn0031640,Mon1,2L,4850641,4852640,1999
FBgn0051660,smog,2L,4852864,4876792,23928
FBgn0031643,CG3008,2L,4883298,4885669,2371
FBgn0031639,mRpS2,2L,4849439,4850419,980
FBgn0031635,tank,2L,4835335,4837999,2664
FBgn0031634,Ir25a,2L,4830846,4835300,4454
FBgn0031633,Fnta,2L,4829214,4830693,1479
FBgn0031631,CG3225,2L,4815613,4818245,2632
FBgn0031627,fipi,2L,4734592,4794044,59452
FBgn0031626,CG15631,2L,4732413,4734458,2045
FBgn0028482,bdl,2L,4324554,4331830,7276
FBgn0020762,Atet,2L,4333913,4345776,11863
FBgn0026319,Traf4,2L,4361925,4380716,18791
FBgn0027560,Tps1,2L,4388327,4392778,4451
FBgn0022153,l(2)k05819,2L,4394196,4400487,6291
FBgn0031601,Dim1,2L,4403251,4403955,704
FBgn0031603,CG15432,2L,4442320,4442985,665
FBgn0031604,Elp3,2L,4444732,4446765,2033
FBgn0040705,ND-B8,2L,4454626,4455207,581
FBgn0031608,CG15435,2L,4459729,4461746,2017
FBgn0031610,Paris,2L,4463611,4465075,1464
FBgn0031611,FIG4,2L,4465174,4468022,2848
FBgn0031613,HP6,2L,4577719,4578218,499
FBgn0011603,ine,2L,4468000,4477022,9022
FBgn0031609,CG15443,2L,4461657,4463447,1790
FBgn0053002,mRpL27,2L,4458595,4459638,1043
FBgn0019982,Gs1l,2L,4455137,4456807,1670
FBgn0031607,Secp43,2L,4453169,4454453,1284
FBgn0031606,CG15439,2L,4449295,4453038,3743
FBgn0025684,MFS18,2L,4446670,4448635,1965
FBgn0027609,morgue,2L,4442870,4444680,1810
FBgn0031602,CG15431,2L,4403992,4441282,37290
FBgn0031600,CG3652,2L,4392770,4393876,1106
FBgn0031598,Vps53,2L,4382925,4386062,3137
FBgn0031597,CG17612,2L,4380722,4382735,2013
FBgn0000547,ed,2L,4031377,4115749,84372
FBgn0014033,Sr-CI,2L,4121702,4124153,2451
FBgn0031585,CG2955,2L,4149279,4151203,1924
FBgn0040102,lectin-24Db,2L,4188123,4189284,1161
FBgn0003941,RpL40,2L,4227699,4228561,862
FBgn0031592,Art2,2L,4277696,4281324,3628
FBgn0031590,CG3702,2L,4224650,4227097,2447
FBgn0001075,ft,2L,4198404,4221796,23392
FBgn0031589,Naprt,2L,4189340,4198071,8731
FBgn0031568,CG10019,2L,3730466,3754617,24151
FBgn0004893,bowl,2L,3771700,3784121,12421
FBgn0031571,bark,2L,3787167,3802726,15559
FBgn0021800,Reph,2L,3803545,3810671,7126
FBgn0003430,slp1,2L,3825675,3827099,1424
FBgn0004567,slp2,2L,3836840,3839185,2345
FBgn0031574,TTLL4B,2L,3862668,3867507,4839
FBgn0051774,fred,2L,3902928,3991713,88785
FBgn0051773,Fpgs2,2L,3911796,3914288,2492
FBgn0000256,capu,2L,3872646,3902860,30214
FBgn0051957,CG31957,2L,3871271,3872458,1187
FBgn0031573,CG3407,2L,3810801,3813410,2609
FBgn0031533,CG2772,2L,3445992,3447589,1597
FBgn0031534,Snx1,2L,3449683,3452106,2423
FBgn0031535,CG12795,2L,3452466,3453755,1289
FBgn0021967,ND-PDSW,2L,3466157,3467334,1177
FBgn0051776,CG31776,2L,3470182,3472364,2182
FBgn0051956,Pgant4,2L,3472603,3475338,2735
FBgn0031544,CG17593,2L,3514872,3517264,2392
FBgn0031546,CG8851,2L,3519677,3522555,2878
FBgn0031550,IFT57,2L,3530789,3532678,1889
FBgn0024244,drm,2L,3539247,3548423,9176
FBgn0015663,Ugt36A1,2L,3619097,3621573,2476
FBgn0031564,CG2816,2L,3703659,3704253,594
FBgn0031566,CG2818,2L,3713360,3716810,3450
FBgn0051955,CG31955,2L,3711881,3713105,1224
FBgn0015376,cutlet,2L,3707230,3711748,4518
FBgn0051777,CG31777,2L,3706551,3707063,512
FBgn0051778,CG31778,2L,3704106,3705488,1382
FBgn0031563,CG10031,2L,3698451,3699092,641
FBgn0031562,CG3604,2L,3697242,3697872,630
FBgn0031561,IM33,2L,3696218,3696658,440
FBgn0031560,CG16713,2L,3695032,3695411,379
FBgn0051779,Acp24A4,2L,3693184,3693905,721
FBgn0031559,CG3513,2L,3692699,3693182,483
FBgn0031558,CG16704,2L,3692123,3692587,464
FBgn0031554,CG15418,2L,3621110,3621704,594
FBgn0002985,odd,2L,3604224,3606756,2532
FBgn0004892,sob,2L,3578013,3580769,2756
FBgn0031549,Spindly,2L,3527387,3530317,2930
FBgn0031545,CG3213,2L,3517273,3519651,2378
FBgn0051954,CG31954,2L,3509058,3510102,1044
FBgn0031542,CG15414,2L,3480755,3491071,10316
FBgn0031540,Pif1,2L,3467342,3470004,2662
FBgn0005616,msl-2,2L,3462218,3466112,3894
FBgn0031538,CG3246,2L,3460322,3461952,1630
FBgn0051953,CR31953,2L,3162515,3163289,774
FBgn0014906,Hydr2,2L,3163645,3169462,5817
FBgn0031517,CG15406,2L,3309222,3311682,2460
FBgn0031520,CG8837,2L,3320245,3323141,2896
FBgn0053281,CG33281,2L,3324237,3326637,2400
FBgn0031526,CG8838,2L,3357646,3358618,972
FBgn0016698,Ptpa,2L,3377002,3378590,1588
FBgn0031529,CG9662,2L,3375832,3376737,905
FBgn0031528,CG15412,2L,3373567,3375711,2144
FBgn0031519,Fign,2L,3316794,3319872,3078
FBgn0031516,CG9663,2L,3294926,3303130,8204
FBgn0011648,Mad,2L,3146056,3159643,13587
FBgn0031505,ND-B14.5B,2L,3144953,3145848,895
FBgn0031468,CG2975,2L,2840124,2842638,2514
FBgn0015521,RpS21,2L,2856070,2857029,959
FBgn0031476,CG8813,2L,2869652,2870649,997
FBgn0031478,CG8814,2L,2874890,2877168,2278
FBgn0051950,Sbat,2L,2878344,2879001,657
FBgn0028970,RabGGTb,2L,2879112,2880708,1596
FBgn0041111,lilli,2L,2885929,2954406,68477
FBgn0031484,CG3165,2L,2977122,2978500,1378
FBgn0025109,Bem46,2L,2988116,2990075,1959
FBgn0025681,CG3558,2L,2992870,2998726,5856
FBgn0031488,Ccdc85,2L,2999286,3016069,16783
FBgn0031490,CG17264,2L,3018508,3021506,2998
FBgn0031492,Prp40,2L,3023226,3026439,3213
FBgn0031494,CG17219,2L,3029253,3030616,1363
FBgn0031495,GABPI,2L,3030539,3032300,1761
FBgn0031498,CG17260,2L,3037230,3038793,1563
FBgn0031500,CG17221,2L,3039976,3041890,1914
FBgn0031501,CG17261,2L,3042551,3043593,1042
FBgn0042627,FASN2,2L,3043947,3056143,12196
FBgn0015600,toc,2L,3068345,3144786,76441
FBgn0031497,SerRS,2L,3035493,3037403,1910
FBgn0031496,CG17258,2L,3032210,3035348,3138
FBgn0031493,Sf3b2,2L,3026252,3029168,2916
FBgn0031491,alpha4GT1,2L,3021309,3023141,1832
FBgn0031489,CG17224,2L,3016441,3018308,1867
FBgn0002989,okr,2L,2989594,2992759,3165
FBgn0031485,CG9643,2L,2978411,2979288,877
FBgn0031483,CG9641,2L,2974859,2976862,2003
FBgn0004584,Rrp1,2L,2969773,2972508,2735
FBgn0024920,Ts,2L,2968293,2969638,1345
FBgn0024947,NTPase,2L,2880704,2885850,5146
FBgn0031479,Prx6a,2L,2877091,2878232,1141
FBgn0051694,Ifrd1,2L,2868627,2874489,5862
FBgn0031473,CG3104,2L,2848989,2855778,6789
FBgn0031466,CG3119,2L,2834887,2837833,2946
FBgn0031435,Elba2,2L,2577687,2579179,1492
FBgn0031437,Arpc5,2L,2580292,2581423,1131
FBgn0041248,Gr23a,2L,2669823,2672186,2363
FBgn0051690,Tmtc1,2L,2677734,2719431,41697
FBgn0031449,CG31689,2L,2725674,2739830,14156
FBgn0031452,Cwc25,2L,2745098,2746944,1846
FBgn0031453,Bacc,2L,2752445,2757975,5530
FBgn0031456,Tnpo-SR,2L,2759924,2763889,3965
FBgn0031458,aph-1,2L,2766233,2767281,1048
FBgn0028398,Taf10,2L,2767890,2768612,722
FBgn0031459,HINT1,2L,2770135,2770904,769
FBgn0031461,daw,2L,2805261,2812376,7115
FBgn0031462,CG2964,2L,2812437,2814429,1992
FBgn0031463,G6P,2L,2814336,2815760,1424
FBgn0004242,Syt1,2L,2772327,2799979,27652
FBgn0031460,CG15399,2L,2770884,2771776,892
FBgn0019830,colt,2L,2768590,2770069,1479
FBgn0026324,Taf10b,2L,2767286,2767845,559
FBgn0031457,Snx21,2L,2763416,2765665,2249
FBgn0031451,CG9961,2L,2743375,2744934,1559
FBgn0026479,Drp1,2L,2581281,2585430,4149
FBgn0031436,ND-B17.2,2L,2579201,2580172,971
FBgn0031434,insv,2L,2575280,2576997,1717
FBgn0026778,Rad1,2L,2573436,2575052,1616
FBgn0041337,Cyp309a2,2L,2564886,2573037,8151
FBgn0031432,Cyp309a1,2L,2562483,2564830,2347
FBgn0031419,CG15390,2L,2374713,2375697,984
FBgn0031420,Atxn7,2L,2375841,2380506,4665
FBgn0031422,PIG-Wa,2L,2383202,2384747,1545
FBgn0031424,VGlut,2L,2400295,2410662,10367
FBgn0031428,CG9886,2L,2420830,2424647,3817
FBgn0000490,dpp,2L,2428372,2459823,31451
FBgn0011818,oaf,2L,2492955,2498846,5891
FBgn0051948,CG31948,2L,2415359,2416720,1361
FBgn0031426,CG18641,2L,2410624,2415322,4698
FBgn0031423,CG3557,2L,2384761,2385792,1031
FBgn0031418,CG3609,2L,2372455,2374627,2172
FBgn0031417,CG3597,2L,2370152,2371524,1372
FBgn0014010,Rab5,2L,2359142,2365273,6131
FBgn0031413,CG9967,2L,2308761,2357356,48595
FBgn0031410,CG17237,2L,2288503,2289416,913
FBgn0051682,Tengl1,2L,2239414,2240593,1179
FBgn0031374,Wdr62,2L,1884622,1944289,59667
FBgn0031378,CG15362,2L,1981176,1982099,923
FBgn0031379,CG7289,2L,1982217,1984514,2297
FBgn0031381,Npc2a,2L,1988290,1988940,650
FBgn0040717,Nplp4,2L,2008414,2009072,658
FBgn0031384,CG4238,2L,2009859,2030788,20929
FBgn0003557,Su(dx),2L,2037714,2044372,6658
FBgn0028952,Kebab,2L,2045494,2048054,2560
FBgn0026396,Or22c,2L,2054589,2057967,3378
FBgn0031388,CG12674,2L,2079919,2081286,1367
FBgn0027509,Tbcd,2L,2147518,2151664,4146
FBgn0031392,AIF,2L,2151754,2155389,3635
FBgn0031393,CG15382,2L,2155753,2156790,1037
FBgn0031399,mio,2L,2217290,2220625,3335
FBgn0031401,papi,2L,2220748,2225544,4796
FBgn0040715,CG15386,2L,2216503,2217246,743
FBgn0031398,daed,2L,2214972,2216311,1339
FBgn0010288,Uch,2L,2212738,2214211,1473
FBgn0031397,CG15385,2L,2209574,2212571,2997
FBgn0031395,CG10874,2L,2189914,2192386,2472
FBgn0000097,aop,2L,2156484,2178754,22270
FBgn0031391,CG11723,2L,2145297,2147275,1978
FBgn0031390,tho2,2L,2137350,2145187,7837
FBgn0031389,CG4259,2L,2127309,2129237,1928
FBgn0040718,CG15353,2L,2006763,2007193,430
FBgn0031377,CG15356,2L,1975463,1980755,5292
FBgn0031375,erm,2L,1950239,1970362,20123
FBgn0031351,CG14352,2L,1611410,1612576,1166
FBgn0011570,cpb,2L,1704902,1706962,2060
FBgn0031357,mRpL48,2L,1710462,1711465,1003
FBgn0031360,CG31937,2L,1729887,1731070,1183
FBgn0045497,Gr22e,2L,1784062,1785286,1224
FBgn0051663,CG31663,2L,1858609,1881480,22871
FBgn0031367,c-cup,2L,1831627,1832565,938
FBgn0051664,CG31664,2L,1824172,1826500,2328
FBgn0051933,CG31933,2L,1821256,1823331,2075
FBgn0031365,CG17650,2L,1758286,1759093,807
FBgn0041249,Gr22f,2L,1755253,1756451,1198
FBgn0027597,CG17712,2L,1750687,1752122,1435
FBgn0031361,CG17652,2L,1731033,1732356,1323
FBgn0000579,Eno,2L,1724768,1729636,4868
FBgn0031359,Rim2,2L,1716244,1724388,8144
FBgn0031356,CG17660,2L,1707132,1710421,3289
FBgn0021906,RFeSP,2L,1612429,1614160,1731
FBgn0051935,Rab3GAP1,2L,1594822,1611157,16335
FBgn0031347,nis,2L,1584866,1587155,2289
FBgn0031327,CG5397,2L,1240036,1243018,2982
FBgn0041097,robo3,2L,1256417,1296596,40179
FBgn0026141,Cdlc2,2L,1344400,1345135,735
FBgn0031344,CG7420,2L,1500784,1502904,2120
FBgn0031343,CG18131,2L,1498455,1500608,2153
FBgn0002543,robo2,2L,1380086,1420453,40367
FBgn0053126,NLaz,2L,1359837,1361821,1984
FBgn0051659,CG31659,2L,1358925,1359790,865
FBgn0031335,CG5565,2L,1354911,1355924,1013
FBgn0051924,CG31924,2L,1354101,1354919,818
FBgn0031333,CG5561,2L,1352970,1354109,1139
FBgn0028481,Tmtc2,2L,922793,958098,35305
FBgn0031296,gNacalpha,2L,1037246,1038685,1439
FBgn0015905,ast,2L,1077948,1080803,2855
FBgn0031298,Atg4a,2L,1080911,1085380,4469
FBgn0031302,CG14340,2L,1112941,1114138,1197
FBgn0031304,TBC1D23,2L,1129316,1132411,3095
FBgn0031306,CG4577,2L,1134693,1141156,6463
FBgn0031307,MFS3,2L,1143201,1147395,4194
FBgn0031310,Vps29,2L,1150766,1151764,998
FBgn0031312,Tango14,2L,1158661,1160220,1559
FBgn0031314,IntS14,2L,1164443,1166425,1982
FBgn0031315,CG14341,2L,1166506,1167211,705
FBgn0051922,CG31922,2L,1170181,1170789,608
FBgn0031318,CG4887,2L,1173009,1177589,4580
FBgn0031319,CG4896,2L,1177690,1182454,4764
FBgn0031321,Tgt,2L,1184065,1185698,1633
FBgn0031320,CG5126,2L,1182297,1184020,1723
FBgn0031317,Charon,2L,1170753,1172805,2052
FBgn0024314,Plap,2L,1167172,1170365,3193
FBgn0031313,CG5080,2L,1160290,1163886,3596
FBgn0031309,Tfb4,2L,1149445,1150677,1232
FBgn0031305,Iris,2L,1132332,1134098,1766
FBgn0016926,Pino,2L,1114654,1128953,14299
FBgn0031299,CG4629,2L,1083091,1102504,19413
FBgn0003310,S,2L,1049674,1077815,28141
FBgn0031295,CG4375,2L,1026105,1026897,792
FBgn0011244,Hsp60B,2L,728362,730564,2202
FBgn0031275,GABA-B-R3,2L,749945,762399,12454
FBgn0031277,CG13947,2L,779173,779655,482
FBgn0041250,Gr21a,2L,780482,782885,2403
FBgn0031279,CG3544,2L,784336,788776,4440
FBgn0051658,Nnf1b,2L,810577,811531,954
FBgn0031282,Pex12,2L,815993,818096,2103
FBgn0015621,Clp,2L,819964,821209,1245
FBgn0010583,dock,2L,825969,833241,7272
FBgn0020545,kraken,2L,852768,854539,1771
FBgn0031289,CG13950,2L,860197,861806,1609
FBgn0002936,ninaA,2L,877302,878270,968
FBgn0002563,Lsp1beta,2L,898500,901316,2816
FBgn0046113,GluRIIC,2L,914086,917805,3719
FBgn0031292,CG15824,2L,877172,885141,7969
FBgn0020305,dbe,2L,868673,869857,1184
FBgn0029095,aru,2L,861849,868354,6505
FBgn0031287,CG4291,2L,851251,852730,1479
FBgn0020304,drongo,2L,833584,851071,17487
FBgn0031286,CG3862,2L,824329,825861,1532
FBgn0031284,PGAP2,2L,818079,819508,1429
FBgn0031281,Saf6,2L,813314,815950,2636
FBgn0000442,Pkg21D,2L,786153,790798,4645
FBgn0026438,Eaat2,2L,737212,744395,7183
